tao tpy rfm wda ans2 ykm ygj nms lhm bhp	ykm ygj
ygj lhm ans2 tao pna lqx dyq	tao pna
rlt ohx ygj mbi ans1 icy rfm hlq rlt dyq	icy
mbi hlq pgd ans2 kxd ykm hir	kxd ykm
pna rfm ans3 hir tao hir tpy tpy	hir tao hir
ygj hlq hir ans3 hcx hlq irg lgh rfm bhp opa	hcx hlq irg
icy ans1 rfm wry	rfm
wry lqx ans3 ygj ygj nvc lhm nms dyq	ygj ygj nvc
irg ans3 kxd ygj dyz ohx ohx lgh	kxd ygj dyz
ans2 nvc ohx icy lqx nvc ykm	nvc ohx
ans2 lgh hcx wda rlt	lgh hcx
ans1 lhm	lhm
tpy rlt hcx nms ans1 pna pna fro	pna
god ans3 nvc bhp irg bhp tao lqx wda	nvc bhp irg
opa lgh ans3 ohx nvc wda	ohx nvc wda
fro ans3 nvc dyq icy fro nms ykm kxd	nvc dyq icy
wry ans1 mbi irg pgd god	mbi
lqx hlq bhp tao ans2 lqx tpy hlq hcx lhm	lqx tpy
bhp ans3 mbi wda ykm	mbi wda ykm
hir ans3 opa lhm pgd nvc lgh	opa lhm pgd
icy nvc ans2 wry icy bhp pgd rfm	wry icy
ygj ans1 ygj	ygj
nms pgd ans3 hvu tpy ykm wda hvu god	hvu tpy ykm
hcx irg ans1 hir hir	hir
fro mbi god kxd ans3 pna nms hir nms	pna nms hir
ohx ans3 icy tpy ygj nvc mbi tpy	icy tpy ygj
rfm opa wry ans3 nms icy tpy lqx	nms icy tpy
ans2 hcx dyq	hcx dyq
irg ohx ans3 pna mbi dyz hcx hcx hlq lqx	pna mbi dyz
wry fro ans2 pna bhp icy tpy lhm	pna bhp
lhm irg god ans2 kxd icy hlq hlq lgh	kxd icy
icy dyz opa mbi ans1 lqx pna fro hvu nms	lqx
mbi ygj ans1 fro hcx	fro
irg ans2 tao pgd hir wry rfm nms	tao pgd
ans3 pgd lgh rfm tpy nvc	pgd lgh rfm
dyq pna tao ans1 kxd	kxd
hvu ans1 mbi	mbi
dyz ans1 ohx lhm nvc irg wry	ohx
wda ans1 nms irg wry	nms
pna ygj ans1 nms god lqx ygj lhm	nms
opa hir ans1 rfm	rfm
hir lgh hlq ans3 pgd fro pna tao	pgd fro pna
nvc pna god dyz ans3 bhp hcx fro mbi mbi	bhp hcx fro
nvc pna rlt ans2 rlt wda irg hlq wda	rlt wda
rfm nvc god ans2 god pna icy irg	god pna
kxd ykm kxd ans1 kxd hcx dyq	kxd
tpy rfm ygj rlt ans3 hvu dyq hlq	hvu dyq hlq
hcx ans1 opa tao lgh fro mbi	opa
hir pna tao tao ans2 fro ohx god	fro ohx
lhm god ygj nms ans1 nms	nms
pna pgd ans1 ygj icy	ygj
mbi icy icy ans1 tao ohx	tao
ans3 lgh fro wda	lgh fro wda
mbi icy ans3 rfm icy wda irg nms icy	rfm icy wda
nvc ans2 opa fro rfm lgh nms	opa fro
nms ans2 mbi lqx pna	mbi lqx
lqx god hir icy ans1 lqx lhm irg nms wry	lqx
nvc kxd icy rlt ans3 hvu tao tpy opa	hvu tao tpy
hlq wda ans1 god god	god
kxd dyz tao ans2 nms nms nms nms wry hcx	nms nms
ans3 bhp ykm lhm	bhp ykm lhm
god pna ykm hcx ans2 hir hlq	hir hlq
ans1 tpy hcx	tpy
opa ans2 mbi irg pna	mbi irg
wda rfm ans3 bhp ohx icy tao	bhp ohx icy
rlt pna ohx lqx ans1 rlt pgd hir	rlt
ykm ans1 kxd hir hcx dyq rfm	kxd
nms nms irg ans1 ygj hir dyz tpy	ygj
nvc god hvu rlt ans3 hlq mbi opa wry	hlq mbi opa
wry icy ans2 hlq rfm opa	hlq rfm
ygj wda ans3 ykm god irg	ykm god irg
rfm nms ans3 wda ohx pgd	wda ohx pgd
irg ans1 god mbi ohx	god
hcx icy lqx ohx ans1 wry ygj	wry
hvu pna ohx ans2 irg pgd pna tpy irg hcx	irg pgd
mbi wry lhm tpy ans1 rlt bhp god	rlt
dyz ans1 kxd ohx	kxd
rlt rlt lqx mbi ans3 rlt lqx ygj hcx mbi irg fro	rlt lqx ygj
ans3 lgh ygj kxd rfm lqx	lgh ygj kxd
god rfm lqx hvu ans3 tao nvc hvu mbi	tao nvc hvu
pna rfm ans1 lgh hvu rfm	lgh
rfm ykm lgh ans3 hir dyq hvu irg nvc god irg	hir dyq hvu
pna dyz opa fro ans3 irg dyz bhp nvc god wry	irg dyz bhp
nms nvc irg ans1 god lhm ykm	god
pna god dyz ans2 hlq lhm wda pgd irg ykm	hlq lhm
ohx ykm mbi ans3 mbi pna pgd	mbi pna pgd
rlt ans2 tao pna	tao pna
icy ans1 mbi kxd rfm tpy pgd	mbi
fro lqx lqx pgd ans3 rfm bhp hvu	rfm bhp hvu
pgd ans3 irg ykm ygj tpy	irg ykm ygj
ygj kxd hcx ans3 irg bhp lhm tao pna dyq	irg bhp lhm
ans2 bhp lgh	bhp lgh
tao ygj ans1 wda tao rfm pna	wda
god ohx ans3 opa hcx tao	opa hcx tao
kxd ygj ans1 rlt tao bhp dyz ygj	rlt
god ohx ans1 hcx kxd	hcx
wry irg ans1 hcx rlt ygj hvu	hcx
ohx ans1 dyz opa nvc	dyz
god ans3 hlq wry nms hvu	hlq wry nms
dyq opa wda hlq ans3 ygj lqx tpy mbi fro hvu	ygj lqx tpy
irg ans1 kxd rfm	kxd
nvc ans1 opa	opa
ans1 opa god god lhm	opa
nvc icy fro tpy ans2 hir dyz rlt ygj	hir dyz
ans1 opa wry opa pgd	opa
lgh kxd ans3 nms ygj mbi nvc lqx	nms ygj mbi
nms ans2 lhm ykm	lhm ykm
hlq pgd ans1 rfm kxd	rfm
tao ans2 lqx pna hvu rfm mbi	lqx pna
opa ans3 rlt icy icy rfm	rlt icy icy
dyz ans1 hvu	hvu
lgh ans3 irg hir opa kxd rlt	irg hir opa
hir ans2 fro hlq fro icy dyq	fro hlq
lhm ans3 lhm wry tao tao hir mbi ygj	lhm wry tao
kxd wry ans3 hcx rfm lqx hlq irg	hcx rfm lqx
pna ans2 tpy nms rfm	tpy nms
ans3 hcx irg dyq opa	hcx irg dyq
ans1 kxd irg hcx tao	kxd
hcx hvu ans1 dyz irg ykm	dyz
opa opa ans3 bhp hvu lhm	bhp hvu lhm
ans3 wda dyz kxd	wda dyz kxd
bhp pna fro ans1 mbi rlt lgh god	mbi
irg lqx tpy ans2 fro tpy pgd ohx	fro tpy
opa ohx rfm ykm ans3 irg bhp ykm hlq	irg bhp ykm
ans3 mbi pgd bhp rlt	mbi pgd bhp
ans2 lqx pna	lqx pna
ans2 lhm wry nvc opa hcx	lhm wry
ans3 lhm god pna fro pna pgd	lhm god pna
lqx hlq kxd ans1 wda	wda
ans2 tao irg pgd god	tao irg
tpy kxd ohx irg ans1 pna	pna
ohx ans2 tpy bhp hvu hvu	tpy bhp
ans3 mbi pna rfm hvu rfm	mbi pna rfm
tao ans3 mbi hlq tao god	mbi hlq tao
tao ans2 irg ygj nvc ykm hvu lqx	irg ygj
rfm hir fro ans3 opa hir rlt	opa hir rlt
rfm tao ohx lqx ans2 nms rlt	nms rlt
tpy icy hir ans2 irg nms wda hvu lqx ykm	irg nms
rlt hir fro ans3 rlt hvu icy lhm ygj	rlt hvu icy
wda dyz hir dyq ans2 lhm wry hlq opa pgd	lhm wry
lqx rfm ans3 wda lgh fro wda nvc tao pgd	wda lgh fro
hir ans3 tao opa opa wda rlt	tao opa opa
ans2 dyq pgd irg	dyq pgd
nms ans3 lgh ykm hvu ygj god kxd	lgh ykm hvu
hlq irg pgd ans1 ygj	ygj
dyq ans3 ygj ykm hvu kxd	ygj ykm hvu
mbi ykm lhm ans1 hlq pna rfm	hlq
tpy ans3 rlt wda lgh	rlt wda lgh
irg lqx hvu ans1 mbi wda nms nms	mbi
ans1 bhp rfm nms kxd	bhp
ans3 tpy rfm fro	tpy rfm fro
wry pgd ans3 pna wda bhp nvc opa	pna wda bhp
bhp lhm nms ans3 nms mbi rfm irg	nms mbi rfm
dyq dyq ans2 icy dyz	icy dyz
pgd hlq ans3 nms nvc ykm hlq	nms nvc ykm
rfm mbi ans3 hir rfm lgh	hir rfm lgh
mbi pna irg fro ans3 tao ygj lhm dyq nms	tao ygj lhm
mbi dyq tpy ans3 wry nvc ykm ohx	wry nvc ykm
god lgh ans2 wry dyz hir fro	wry dyz
ans2 hvu lhm lhm hir lhm irg	hvu lhm
dyz ans3 lgh pna ygj nvc ohx pna	lgh pna ygj
nvc pgd lhm ygj ans1 tpy god dyz	tpy
ans1 irg hcx god	irg
tpy ykm rlt ans1 opa ykm ygj	opa
fro ans3 pna pna dyq lqx hvu	pna pna dyq
mbi fro ans2 nms lhm irg tpy ohx lqx	nms lhm
hcx hcx ans1 lgh tpy pgd lqx lgh	lgh
ans2 dyq hvu dyq mbi	dyq hvu
rlt dyz ans1 bhp nvc hcx dyz	bhp
ohx ans2 nms dyz rfm	nms dyz
hvu dyz ans1 nms	nms
ans3 pna hlq wda	pna hlq wda
wry ans2 pna ygj hvu	pna ygj
pgd ans1 pna	pna
ygj ans3 ygj icy tpy nms wda kxd	ygj icy tpy
hvu ohx fro ans1 hlq bhp nvc tao icy	hlq
ans1 lgh tao	lgh
pna tao ohx ans2 pgd fro hvu lgh mbi	pgd fro
rlt hlq bhp fro ans2 hlq dyq ohx	hlq dyq
lqx ans3 nvc nvc irg wry pgd pna icy	nvc nvc irg
pgd ans2 hir icy icy fro	hir icy
fro ans1 bhp lgh pna ohx	bhp
nms rfm ans3 pgd wry lhm pna	pgd wry lhm
dyz ans3 dyz lgh rlt kxd	dyz lgh rlt
rlt god ans3 pgd hir tao	pgd hir tao
rfm hcx dyq ans2 dyq hcx hvu wda	dyq hcx
rlt god ans3 lhm tao hcx god	lhm tao hcx
ohx ans1 lhm irg	lhm
tao nms ans3 tpy nvc ykm hir	tpy nvc ykm
lhm lhm opa ans1 tpy	tpy
lgh ans3 lgh lgh wry	lgh lgh wry
opa ans2 dyq wry wry opa	dyq wry
dyz lhm ans2 hcx bhp tpy	hcx bhp
wda wry ans3 irg lgh god rfm ygj opa	irg lgh god
ans2 hlq tao mbi	hlq tao
wry icy ans3 hlq lqx hvu pna lgh nvc tpy	hlq lqx hvu
pna mbi lgh ygj ans3 wda dyz rlt lqx kxd rfm	wda dyz rlt
rlt tao opa ans3 wda ygj ygj nms ygj pna	wda ygj ygj
lgh wda tao god ans2 dyz nms wry hcx lgh	dyz nms
pgd ans2 wda dyz opa mbi pgd irg	wda dyz
bhp icy pgd kxd ans1 mbi mbi	mbi
god tao hir hir ans2 wda irg opa god kxd ygj	wda irg
ykm wda ans2 opa fro	opa fro
wry dyq ans2 tpy kxd ygj ohx	tpy kxd
hlq ans1 pna wry hir	pna
nms mbi bhp ans1 ohx ohx wda	ohx
bhp ykm ans1 lqx rlt hir pna hvu	lqx
pna icy ans3 wda irg dyz	wda irg dyz
ykm god rfm ans3 lgh pgd ygj pgd	lgh pgd ygj
wda pgd ans1 hcx hir nms	hcx
nvc ans3 rlt hir icy	rlt hir icy
lhm dyq ans3 irg hir lqx rlt icy	irg hir lqx
wry irg hvu kxd ans2 kxd fro lqx ykm tao hvu	kxd fro
rlt ans2 ykm rfm dyq lqx	ykm rfm
icy ohx ans3 dyq wda tao bhp ykm dyz	dyq wda tao
rfm ans2 ohx hcx wda mbi hlq	ohx hcx
ygj nvc ohx ykm ans2 wda hlq pna	wda hlq
ans1 dyq icy nms icy wda	dyq
lhm lqx ans1 dyz wry hvu	dyz
god ans3 dyq fro god ohx	dyq fro god
mbi ans3 lhm god kxd opa icy	lhm god kxd
hir lgh ans1 lqx fro wda wry dyq	lqx
ykm dyz lgh ans2 ykm irg	ykm irg
ans3 ygj hlq tao opa lhm ykm	ygj hlq tao
wda bhp nvc lqx ans1 ygj	ygj
hcx kxd ygj pna ans1 hlq irg pgd ykm tpy	hlq
lqx pgd rlt wry ans3 dyz nvc ygj tao tao god	dyz nvc ygj
rlt kxd ans2 lhm pgd	lhm pgd
hvu pgd god ykm ans1 lgh hcx pna rfm pgd	lgh
opa ans1 wry ykm nms ygj fro	wry
ohx nvc fro dyz ans2 nms hcx	nms hcx
hcx mbi ykm ans1 pgd irg	pgd
nms ans1 icy nms hvu hir	icy
dyz wry ans1 mbi dyz pna dyq	mbi
rfm hlq bhp ans2 hvu icy lhm hlq	hvu icy
kxd kxd lqx ans1 ykm rlt	ykm
irg lgh ygj ans2 hvu fro hlq nvc	hvu fro
hir rfm god ans1 nvc dyz	nvc
nvc pna ans3 hir ygj rfm pna	hir ygj rfm
hlq wry ans2 bhp mbi ygj god	bhp mbi
wry fro ans3 lqx rlt pgd pna dyz	lqx rlt pgd
pna lhm ans1 ohx hir irg ohx nvc	ohx
ans3 lhm god nvc	lhm god nvc
hvu rlt hir dyz ans2 lqx god bhp	lqx god
wry nvc ans1 wda fro tao irg	wda
dyq ans1 pna	pna
ans3 hir nvc hir hlq	hir nvc hir
god ans3 hlq dyz opa lqx nms ykm tao	hlq dyz opa
god lqx ans3 god tao god hvu	god tao god
pgd ans1 lqx wda mbi hlq	lqx
ykm tpy ans3 rfm dyz bhp	rfm dyz bhp
ans2 rfm ygj fro wry	rfm ygj
hvu ykm pna ans3 rlt opa hir icy god tao	rlt opa hir
nms tao rlt ans1 opa icy rfm pna	opa
mbi dyz wda lqx ans2 mbi kxd nvc hlq tao nms	mbi kxd
hvu icy pna nms ans2 wry nvc rlt dyz icy hlq	wry nvc
hir icy fro fro ans2 hcx nvc bhp	hcx nvc
nvc mbi ans1 wry	wry
hcx dyq irg hlq ans2 hir lgh lgh god	hir lgh
ohx lgh ans2 rlt hlq hir	rlt hlq
irg ans3 wry ykm fro hvu irg dyq	wry ykm fro
lgh ans3 dyz hvu ygj fro fro kxd fro	dyz hvu ygj
wry irg ans1 hir kxd ykm	hir
ans3 ykm lhm lgh tao dyz hlq rlt	ykm lhm lgh
tpy ans1 nvc pna	nvc
hir pna ans1 ohx	ohx
ans1 wda	wda
ygj ans1 hcx nvc dyz nms	hcx
lqx wry kxd mbi ans3 hcx kxd pna	hcx kxd pna
dyq wda ans3 pna tpy nms wda	pna tpy nms
mbi ohx tpy ans3 hvu nms lqx lhm pgd	hvu nms lqx
ans3 kxd opa hvu ohx hvu	kxd opa hvu
bhp pgd wda ygj ans1 ykm hvu	ykm
hvu ans1 god hir	god
pna nvc hir ans2 tpy ygj rlt hir nms	tpy ygj
ans1 ygj nms	ygj
fro ygj irg ygj ans1 opa opa irg nvc	opa
fro dyq kxd ans3 god dyz rlt wda ykm lhm hcx	god dyz rlt
lhm hvu ans2 dyz mbi pgd icy ygj	dyz mbi
nms nvc dyq ans1 pna ygj opa bhp	pna
ohx nvc rlt wda ans3 god wda hlq	god wda hlq
lgh irg fro ans3 hvu bhp ohx kxd	hvu bhp ohx
bhp hvu ans2 fro lqx fro pna hvu wda	fro lqx
icy hlq wry ans2 hvu fro nvc ygj	hvu fro
wry ans1 hlq icy mbi pna	hlq
lhm nms icy ans2 nvc mbi hir dyq wry	nvc mbi
ygj ans2 nms nms	nms nms
nms irg ans1 kxd nms	kxd
ygj tpy mbi ans1 kxd wry dyq	kxd
ans2 ohx nms	ohx nms
ohx nvc ans3 kxd hcx fro	kxd hcx fro
kxd dyz irg ans3 wda fro lgh	wda fro lgh
lqx rfm ans2 icy rfm pna god	icy rfm
hcx irg ans2 irg pgd hvu fro	irg pgd
ans3 lqx pna lqx wry	lqx pna lqx
ans1 nms ohx rlt	nms
icy hlq ans3 lqx tpy kxd tao wry rfm	lqx tpy kxd
dyq ans2 mbi ykm nvc	mbi ykm
icy dyz mbi ans3 hvu hcx dyq	hvu hcx dyq
dyq ans2 rfm hcx	rfm hcx
hir hlq bhp ohx ans3 lgh mbi dyz tao lgh ohx	lgh mbi dyz
lgh nvc nms hvu ans3 hvu icy icy lgh ykm ohx	hvu icy icy
god ans3 irg hir rlt	irg hir rlt
pna god ans3 dyq god ykm kxd	dyq god ykm
ans1 god wda tao mbi hcx	god
ans2 pgd god pgd nvc mbi	pgd god
ans1 opa wda tao ygj	opa
tpy tao wda wry ans3 opa ykm lgh nms lgh ykm pna	opa ykm lgh
ans2 lgh hlq ykm irg ygj	lgh hlq
lhm hvu pgd dyz ans3 nms god tpy pna icy	nms god tpy
hir lhm lhm ans2 lhm ygj	lhm ygj
bhp tpy ans3 dyz tpy fro god lgh	dyz tpy fro
nms icy nms ans1 pgd wry wda nvc lgh	pgd
ykm ans3 icy hcx icy kxd	icy hcx icy
kxd ans1 hir ygj ykm rfm	hir
ans3 wry lqx tpy lgh	wry lqx tpy
lgh ygj tpy ykm ans3 dyz god pgd ykm	dyz god pgd
dyz irg tao pgd ans3 ykm dyz hvu nvc hlq ohx	ykm dyz hvu
wry hlq rlt bhp ans3 kxd hlq hvu dyz fro lgh ohx	kxd hlq hvu
hcx wda lqx ans3 rlt fro lhm tao wry hlq	rlt fro lhm
tao pgd ans2 hlq ygj wry ykm lgh fro	hlq ygj
ans2 icy god rfm	icy god
kxd god lhm hvu ans1 ohx hir god wry	ohx
nms ans1 mbi rfm lqx	mbi
wda dyq kxd fro ans3 god rfm nms	god rfm nms
pgd wry lhm ans2 rfm god hir nms wda	rfm god
hcx ans3 nms icy irg	nms icy irg
irg bhp ans1 lqx hcx rfm irg icy	lqx
god ans1 ygj ohx icy lqx bhp	ygj
opa hcx lqx ans2 hir tpy mbi mbi	hir tpy
rlt hvu ans1 kxd nvc	kxd
kxd ygj rlt ans3 hlq opa hcx kxd opa	hlq opa hcx
pna lhm bhp ans3 tpy ygj irg hir ygj wda lhm	tpy ygj irg
rfm mbi hvu ans2 lqx dyq	lqx dyq
ygj irg lhm ans1 fro ykm hvu hlq	fro
ans1 hir wda	hir
hcx bhp lgh ans3 ygj nms opa god	ygj nms opa
tpy pna tao ans2 god ygj lqx	god ygj
wda icy dyq ans1 hcx	hcx
dyz opa ans1 wda tao tao	wda
nms pna irg nvc ans1 hcx	hcx
hvu ans3 nvc nvc nms ygj irg tpy	nvc nvc nms
dyq lhm lqx pna ans2 tpy wry dyz hcx hcx	tpy wry
god ohx ans1 nvc fro	nvc
mbi hlq ans3 nvc hvu ykm dyq nms	nvc hvu ykm
hvu wda rfm ans2 ygj dyz lqx nvc nvc	ygj dyz
dyz ans1 dyq	dyq
kxd bhp wda mbi ans3 hvu dyz lhm hcx	hvu dyz lhm
ans1 pna hvu ygj nms	pna
hvu ans2 rlt irg icy ohx	rlt irg
nms lhm ans2 rlt nms tao hir opa nvc	rlt nms
rfm ans2 lhm dyz mbi hvu irg	lhm dyz
opa nms lgh wry ans1 ygj icy	ygj
ygj kxd god mbi ans1 ohx opa tpy	ohx
wda ans3 fro mbi lhm rlt hir	fro mbi lhm
ans2 hvu ygj hvu lgh ykm	hvu ygj
rfm ykm icy icy ans1 nvc hvu	nvc
pna bhp kxd wda ans1 tpy bhp tao	tpy
bhp ans2 kxd hir mbi	kxd hir
ans1 hlq	hlq
ans2 dyz opa rlt kxd ygj irg	dyz opa
god nvc ans3 lhm hvu hcx	lhm hvu hcx
icy icy bhp dyz ans1 pgd hcx icy lqx wda	pgd
ans2 ykm tao pna icy	ykm tao
icy ans1 dyq wda wry	dyq
ohx ans1 dyz ykm hvu hir	dyz
kxd bhp ohx ans1 ygj wry irg hir	ygj
wda hvu ans3 pna nms mbi pna lgh wry	pna nms mbi
pgd ans1 bhp kxd wda pna pna	bhp
lhm nms hlq tao ans1 lgh lgh hir bhp ykm	lgh
bhp lgh icy ygj ans2 opa god pna wda	opa god
god ans1 lhm ygj kxd	lhm
nms fro opa ans3 hlq wry wda	hlq wry wda
ans2 nms ygj rlt fro lqx hvu	nms ygj
lgh kxd ans2 lqx lqx ohx	lqx lqx
ans3 nvc pna tpy	nvc pna tpy
tpy ygj ans2 lqx kxd	lqx kxd
lqx wda tao kxd ans2 ohx ykm icy tpy hcx	ohx ykm
icy nms ans2 pgd bhp pna pna wda	pgd bhp
bhp ans2 ohx dyz ykm hir pna rlt	ohx dyz
tao ans3 ohx ygj ykm	ohx ygj ykm
ans2 hcx ygj opa	hcx ygj
lhm ans3 hlq ohx hcx mbi hir hcx	hlq ohx hcx
pna rfm ykm ans1 tpy pgd wry hir hcx	tpy
mbi rlt kxd rfm ans2 opa nvc fro	opa nvc
wry ohx ans2 dyz mbi hvu	dyz mbi
pgd hlq ans2 opa hvu lqx pna	opa hvu
ans3 ygj kxd lhm lqx wry hcx	ygj kxd lhm
ans2 wry pgd	wry pgd
icy rfm mbi irg ans1 lgh wry	lgh
kxd bhp nvc ans1 hvu dyz wda ykm	hvu
wda tpy rlt hlq ans3 nms ohx lhm dyq rlt lqx	nms ohx lhm
lgh irg mbi ans1 opa ygj dyz nms hir	opa
hir ans2 pgd fro bhp	pgd fro
ans3 rfm nvc wda dyz tpy nms hir	rfm nvc wda
ohx rlt lhm ans2 kxd lgh	kxd lgh
lgh ans1 god wda	god
wda icy ans1 fro wry lgh dyq hcx	fro
ans2 pgd dyz	pgd dyz
hcx rfm fro icy ans2 tao lhm dyz icy dyz wry	tao lhm
dyq tao rfm ans3 tao hcx tao nms lqx wry icy	tao hcx tao
god tao ans1 hvu tao wry pna	hvu
dyq pgd ykm ans2 dyz opa hir bhp kxd irg	dyz opa
ans2 god rlt lhm bhp icy kxd	god rlt
ans3 lhm hlq irg ohx ohx fro wda	lhm hlq irg
ans1 bhp icy wda	bhp
bhp mbi icy wry ans2 dyq dyz	dyq dyz
hir tpy ans3 icy lqx lqx god rfm rfm	icy lqx lqx
kxd ans1 dyz	dyz
mbi fro opa ohx ans1 tpy rlt	tpy
tao ykm ans2 pgd pna dyq tao	pgd pna
ohx dyz hlq rlt ans2 dyq lqx god wry opa rfm	dyq lqx
ans3 rlt irg god tao pgd	rlt irg god
hlq lqx ans2 dyq irg	dyq irg
ans2 rfm lhm	rfm lhm
ans1 rlt lqx icy rfm	rlt
ans3 tpy irg hlq ohx dyq irg nvc	tpy irg hlq
wry ans2 tpy nms bhp rlt	tpy nms
wry tpy ans3 lqx god ygj tao	lqx god ygj
hvu lqx rfm ans1 nvc nms ohx	nvc
wry kxd god ans3 hcx kxd rlt tao dyq	hcx kxd rlt
pna hir kxd irg ans1 hlq kxd pgd tao lgh	hlq
nms ans2 fro dyz pna tao lqx pna	fro dyz
hcx hlq ans1 hcx ykm tpy hvu	hcx
icy tpy hcx ans3 lgh opa wry opa god mbi	lgh opa wry
irg ans2 hcx rfm opa pgd	hcx rfm
hir lhm dyz ans2 opa opa	opa opa
pgd hvu hlq bhp ans1 opa fro	opa
wda ans1 ohx	ohx
kxd ans2 ygj lgh nvc wry wda wry	ygj lgh
ans1 hcx mbi wry irg	hcx
nvc ans1 kxd	kxd
tpy hvu kxd hvu ans1 lgh fro	lgh
lhm rlt wda ans2 fro fro bhp mbi wda god	fro fro
ans3 icy irg ykm mbi	icy irg ykm
hcx wda pna ans3 kxd hir nms pna wda ygj god	kxd hir nms
hir hcx ygj nvc ans2 lhm bhp lhm ygj	lhm bhp
ans1 ygj kxd pna lqx	ygj
hir fro ans3 pna ygj dyz rfm	pna ygj dyz
hir ygj ygj ans2 nms nvc irg pna	nms nvc
ans1 nms dyq wry nvc	nms
lqx dyz ans3 tpy ohx ohx opa bhp god lhm	tpy ohx ohx
ykm irg ans1 fro opa hir	fro
lqx mbi hvu ans3 tpy rlt dyz hlq hvu tpy	tpy rlt dyz
nms hir lqx ans3 nvc hcx dyz lgh	nvc hcx dyz
icy ygj hlq pna ans2 wry dyq icy rfm nvc god	wry dyq
lgh tpy ans1 god lqx dyq tao pna	god
opa ans3 kxd god lqx dyq pna bhp	kxd god lqx
opa dyz ykm icy ans3 irg dyz icy ykm fro pna nvc	irg dyz icy
opa wry hir ans2 hlq hvu icy mbi	hlq hvu
lgh lhm hlq ykm ans3 mbi ygj rfm icy mbi ygj lqx	mbi ygj rfm
wda tpy hvu nms ans1 hir	hir
kxd ans1 wry pgd	wry
ans2 hvu kxd	hvu kxd
dyz wda hlq lqx ans3 wda icy irg lqx	wda icy irg
lqx lhm opa ans2 ygj ohx opa nms wda ohx	ygj ohx
hlq ans3 tao icy kxd	tao icy kxd
rlt lhm tpy lgh ans2 icy lhm kxd opa lgh ykm	icy lhm
ykm bhp icy wda ans3 hcx nvc lqx icy	hcx nvc lqx
lhm ans2 mbi wda wda ohx rlt	mbi wda
hlq rfm god ans3 hvu opa tpy hir	hvu opa tpy
ygj ygj god ans2 lqx lhm	lqx lhm
fro nms ans1 nms nms	nms
lgh tao pna nvc ans2 lqx ohx ohx rlt irg nms	lqx ohx
ans1 rlt hir nms hlq	rlt
wda lhm ans3 ohx lqx mbi tao	ohx lqx mbi
opa dyz ans2 mbi ykm hir rfm	mbi ykm
tpy lgh irg tao ans3 ykm wda wry tpy bhp hir dyq	ykm wda wry
hvu ans3 pna ygj god opa hcx hlq	pna ygj god
lqx kxd pgd ans3 lhm hvu wry bhp rlt rfm bhp	lhm hvu wry
rlt ans3 bhp icy tao hvu hir lgh	bhp icy tao
hvu ans2 tao dyz wry tao bhp	tao dyz
fro lqx tao ans3 hcx nms tpy god	hcx nms tpy
hir pgd rlt ans3 god ykm rfm ohx ohx pna	god ykm rfm
rlt kxd ans3 dyq hir lqx hir wry dyz wry	dyq hir lqx
ygj ans1 ohx icy lqx rlt	ohx
ans3 hvu icy mbi rlt fro nms	hvu icy mbi
nvc ans3 pna dyz lqx pgd pna	pna dyz lqx
hcx ans2 tpy tpy opa lqx hlq	tpy tpy
wda lgh ans2 opa nms hir	opa nms
pna god hcx god ans3 hir rfm opa rlt dyz dyz	hir rfm opa
ygj fro ans1 nms lqx	nms
opa rlt god ykm ans3 hcx ygj irg lqx nms	hcx ygj irg
nvc dyq lqx pgd ans1 dyq	dyq
icy icy ykm ans1 nms kxd nms rlt	nms
god nms tao ans3 dyz wda fro pna hlq rfm ygj	dyz wda fro
nms dyq pna ans2 wry nms	wry nms
wry ans1 hir rlt	hir
ykm kxd tpy ans3 rfm tpy ykm	rfm tpy ykm
kxd god hcx ans1 dyz ygj rfm hir	dyz
rlt icy ans2 ykm lqx nms nms	ykm lqx
pgd ans1 icy lhm ykm	icy
pna pgd nms nvc ans2 kxd hcx rfm bhp	kxd hcx
wry fro icy ans3 ygj wda hlq icy wry	ygj wda hlq
dyz wry pgd fro ans2 irg irg icy ygj	irg irg
hvu kxd nvc dyq ans2 nms nvc wry tpy	nms nvc
ans3 kxd god hcx lgh nms dyz	kxd god hcx
ans1 fro nvc fro ykm	fro
hlq ykm mbi hvu ans1 ohx	ohx
irg pna ans3 mbi bhp ygj hvu	mbi bhp ygj
ans3 lhm lhm irg hlq ykm nvc	lhm lhm irg
lgh fro lqx pna ans1 ykm hlq hvu hlq pgd	ykm
ans3 nvc nvc pgd rfm ygj lqx bhp	nvc nvc pgd
wda wda fro ans3 opa opa wry	opa opa wry
ykm ans3 ohx nvc tao wry	ohx nvc tao
ans2 pna nvc nms	pna nvc
wda ans3 lgh dyq bhp fro ykm	lgh dyq bhp
dyq lgh ans2 tao lhm hlq god	tao lhm
nvc ans3 dyz nms hlq hcx hcx lqx	dyz nms hlq
dyz nms ans2 tpy bhp lqx hir	tpy bhp
tao wda ans2 opa ohx ohx hvu dyz rlt	opa ohx
tao tpy kxd kxd ans3 bhp mbi nms wry lqx hlq wry	bhp mbi nms
pna ans2 wry mbi hcx ohx hlq irg	wry mbi
ans3 god hvu ohx dyq hir opa	god hvu ohx
bhp ans3 tao lqx dyq	tao lqx dyq
dyq nvc tpy god ans3 tao lgh irg lgh	tao lgh irg
lqx nvc god opa ans1 dyq	dyq
wry ans3 tpy lqx dyq	tpy lqx dyq
ans2 ykm tao wda dyq lgh	ykm tao
tpy ohx tpy opa ans1 rlt fro tao	rlt
ans1 ygj	ygj
nms mbi ans3 bhp dyq bhp	bhp dyq bhp
hir rfm ans3 hvu irg bhp ykm pna rlt mbi	hvu irg bhp
fro mbi hlq dyq ans3 hcx nms tpy ygj wda bhp	hcx nms tpy
rfm bhp dyq pgd ans3 lhm ohx ohx kxd tao	lhm ohx ohx
dyz nms kxd opa ans2 ohx hlq bhp dyq kxd	ohx hlq
ykm ans1 tpy god hcx ohx	tpy
lhm rlt nms ans3 kxd wry nvc tao opa	kxd wry nvc
hvu lqx tpy tpy ans2 wda hlq tpy mbi lqx dyz	wda hlq
hlq nvc opa hvu ans1 lhm ohx hcx nms	lhm
dyz rlt lqx ans3 nms pgd dyz pgd bhp tpy	nms pgd dyz
god ohx ans2 rfm hcx wry hcx	rfm hcx
opa lhm dyz opa ans2 lqx nvc bhp ygj	lqx nvc
hlq dyz opa icy ans3 pna dyq hir	pna dyq hir
lhm lqx ans2 opa bhp	opa bhp
god dyq pna ans2 pna kxd mbi pna ohx fro	pna kxd
ygj irg god ans1 nvc dyz hcx	nvc
tao ans2 lqx lhm fro god	lqx lhm
wry dyq ykm ans1 lhm	lhm
hcx ans1 pgd tao	pgd
nms pna ygj ans2 hlq kxd	hlq kxd
ykm bhp god hcx ans3 wry ygj lqx icy	wry ygj lqx
rlt ans2 nms lhm wda rlt dyq hvu	nms lhm
ans3 mbi lhm dyq	mbi lhm dyq
nms ans3 opa dyz rlt icy	opa dyz rlt
hvu wda fro hlq ans2 bhp lhm pgd ykm mbi kxd	bhp lhm
lqx ans2 bhp hvu lgh hvu fro	bhp hvu
ygj ans1 tao hvu pgd mbi	tao
hcx rfm nms hcx ans2 hvu rlt	hvu rlt
hcx bhp god mbi ans1 dyz dyq dyz hvu	dyz
dyq ans3 dyz pna dyz irg	dyz pna dyz
ykm ans2 hvu lgh dyq	hvu lgh
ans3 pna dyq hcx lgh lgh lqx lhm	pna dyq hcx
nms wry nvc ans2 irg dyq	irg dyq
opa ans3 hcx icy tpy kxd wda rlt tpy	hcx icy tpy
ans3 bhp hlq hvu hlq fro	bhp hlq hvu
ans2 god bhp	god bhp
fro nvc ykm ans3 hlq lhm pgd fro hvu	hlq lhm pgd
nvc hlq pgd ans2 icy nvc	icy nvc
pgd ans1 lhm dyq ygj rlt	lhm
ans1 ygj nms bhp nvc	ygj
mbi rfm ans1 opa lhm	opa
opa kxd opa ygj ans1 god lgh bhp icy lhm	god
ans1 ygj tao hcx rfm lgh	ygj
tao nms tao lqx ans2 pgd hvu pna kxd ykm	pgd hvu
ykm ans1 tpy god	tpy
kxd ans2 god kxd irg nvc mbi	god kxd
tpy ygj nvc hcx ans3 fro kxd god pgd pgd fro hvu	fro kxd god
fro ans2 hvu rfm tpy nvc hir irg	hvu rfm
bhp ohx nms hcx ans3 nvc hlq nms	nvc hlq nms
hir icy ans1 wry kxd nms hir	wry
icy lgh icy ans1 dyq nms hvu tao dyq	dyq
nms rlt ygj ans3 god ygj wda ykm rfm	god ygj wda
bhp lqx nvc tpy ans2 dyz opa ohx	dyz opa
ykm wda ans1 pgd	pgd
opa lqx rlt nvc ans3 hcx nms mbi icy	hcx nms mbi
god fro ans2 hlq nms dyz	hlq nms
mbi ykm tpy kxd ans2 hlq irg	hlq irg
pgd lqx rlt lhm ans1 rfm lhm lqx	rfm
tao tpy ans3 ohx pna mbi pgd bhp	ohx pna mbi
lgh dyq irg ans1 hlq wry pna	hlq
ykm hlq ans3 wry rfm tao pgd	wry rfm tao
lqx rfm ans2 fro hlq rlt tpy ykm	fro hlq
bhp lqx ans1 lqx ygj ohx dyq	lqx
lqx ans3 pgd dyz mbi hcx god lqx icy	pgd dyz mbi
wda god ans2 lhm hcx lqx god bhp	lhm hcx
ygj ans2 dyz mbi hvu rlt ykm lqx	dyz mbi
ans2 hlq nvc hcx lqx dyq	hlq nvc
ans3 lgh wda lqx pgd	lgh wda lqx
lhm lqx ans2 hir rlt nvc hlq	hir rlt
tao lhm ans3 nms bhp tao ygj tao ykm nvc	nms bhp tao
lgh wda nms rlt ans3 hir nvc ohx bhp fro nms	hir nvc ohx
hlq ans2 wda opa kxd tpy	wda opa
god tao ans1 hir	hir
lhm rfm ans2 hlq wda pna	hlq wda
ygj hcx ygj ans1 lgh rlt rfm	lgh
ans2 nvc hcx lgh	nvc hcx
ykm dyq nms ans2 mbi tpy hir	mbi tpy
rfm mbi nvc ans3 kxd ykm fro dyz lhm lqx god	kxd ykm fro
lhm lqx rfm lhm ans1 hvu	hvu
ans1 tpy ykm pna	tpy
kxd ans1 ygj hir	ygj
ans1 dyq icy mbi ykm hcx	dyq
ans1 hlq	hlq
lgh fro ykm rlt ans3 hcx ykm hvu hir lqx hvu icy	hcx ykm hvu
dyz dyz ans2 wry lhm ygj ohx ykm	wry lhm
bhp ohx rfm rfm ans3 tpy dyz fro	tpy dyz fro
lgh kxd icy ans3 dyz lhm rfm kxd dyz icy	dyz lhm rfm
pgd pgd hlq ans2 lhm hvu fro	lhm hvu
hvu tao ans2 hir wry ykm rlt tao kxd	hir wry
ans3 nms lgh rlt wda tao hir	nms lgh rlt
nvc god wry ans3 tao lqx lgh lgh hir god	tao lqx lgh
hir ans1 tao icy	tao
bhp dyq ans1 dyq	dyq
bhp fro tpy ans2 irg ohx fro lgh dyq opa	irg ohx
lgh lhm lhm ans2 wda irg dyq	wda irg
ans2 dyz rfm nms	dyz rfm
dyz nms wry rfm ans1 lhm	lhm
lhm hlq irg ans2 icy bhp dyz rlt nms	icy bhp
nms nms lqx ans2 dyz mbi pna	dyz mbi
ans2 pgd nms dyz	pgd nms
wda lgh opa wry ans2 pna rfm nms ohx	pna rfm
hcx god tpy rfm ans1 hir ygj lhm ygj wda	hir
hlq ykm ykm pgd ans1 mbi rlt	mbi
nms hir dyz ans2 tao bhp mbi tao dyz	tao bhp
tao pgd dyq tao ans3 hvu tpy nms fro ygj bhp	hvu tpy nms
pna ans1 rlt ykm irg	rlt
ans2 pna fro wry irg icy	pna fro
god pgd fro ans2 lgh wda lhm	lgh wda
tpy pna ans2 opa ygj pna tpy	opa ygj
hlq ykm hcx ans1 lhm hvu	lhm
kxd ans3 god ykm pgd ykm	god ykm pgd
nms dyq pna rfm ans2 dyq rlt opa nms lqx dyz	dyq rlt
lgh kxd kxd ykm ans1 lqx nvc	lqx
wda hir wda hir ans2 hcx bhp lhm tpy	hcx bhp
nvc irg pna irg ans1 hcx rlt ohx hlq lqx	hcx
fro ans3 ykm lhm tao pgd	ykm lhm tao
wry ans3 hvu tpy ykm nms	hvu tpy ykm
ans2 tpy wda god hir kxd	tpy wda
god nms wry ans1 tpy hvu hcx rlt	tpy
ans1 hir dyq wda	hir
kxd wry ygj dyz ans3 ygj nvc lgh	ygj nvc lgh
ans2 ohx lhm rfm pgd icy irg	ohx lhm
ans1 lqx hvu god	lqx
lqx ans1 ygj rlt pgd kxd tao	ygj
rlt ans2 tao dyz mbi dyz tao	tao dyz
rfm ans2 tpy opa wda hir pna tao	tpy opa
ohx pna ans2 dyz lgh tpy dyz mbi	dyz lgh
hir dyz ans3 bhp fro opa lhm ohx tao	bhp fro opa
rfm dyq god ans3 icy hcx lqx lqx	icy hcx lqx
ans3 dyq bhp hcx	dyq bhp hcx
kxd mbi kxd ans1 rfm pgd	rfm
wry ykm pgd ans1 opa hcx	opa
dyq ans3 tao lqx rfm	tao lqx rfm
icy pgd ans2 opa nms	opa nms
opa mbi opa dyz ans3 dyq hvu fro hcx rfm fro ygj	dyq hvu fro
tpy lhm ans1 dyq pgd pna opa rfm	dyq
kxd wry dyq lqx ans2 nms icy ykm	nms icy
rlt tao hvu ans3 rlt ohx hlq ohx	rlt ohx hlq
ans1 god kxd	god
bhp wry lqx bhp ans3 ohx lhm tao pgd wry nvc	ohx lhm tao
ans3 kxd hlq hir god	kxd hlq hir
ans3 rfm opa kxd bhp nms dyz hvu	rfm opa kxd
nms irg pgd ans1 icy ohx	icy
ans1 ygj bhp	ygj
ykm rfm ans3 wry ykm pgd nms hir lqx	wry ykm pgd
tao pgd pgd wry ans3 lqx icy kxd irg	lqx icy kxd
rlt ans3 ykm dyz hcx nvc	ykm dyz hcx
irg ans1 ygj irg pna fro	ygj
god fro nvc ans1 bhp nvc pna irg god	bhp
ykm ygj fro ans2 tpy opa	tpy opa
god pna nms tao ans3 fro pna ykm dyz ygj icy kxd	fro pna ykm
tpy hvu hvu hlq ans1 lgh nms tpy bhp	lgh
dyq hlq ans3 icy ygj hcx pgd	icy ygj hcx
irg ans3 hcx fro ohx	hcx fro ohx
ans3 bhp hvu ykm lgh rfm	bhp hvu ykm
hlq lqx ans1 lqx bhp ygj	lqx
pna tao ans2 ygj lqx pgd nms	ygj lqx
ygj pna hcx ans2 hir icy wry dyz mbi ykm	hir icy
mbi pgd bhp ans3 lqx tao nvc	lqx tao nvc
dyq hvu ans3 tpy fro lgh nms lhm opa rlt	tpy fro lgh
ans3 rlt bhp tao opa dyq lhm fro	rlt bhp tao
ans3 lhm rlt god	lhm rlt god
ans1 pna dyq kxd	pna
icy mbi ygj ans3 hcx dyz nms god	hcx dyz nms
lqx rfm ans2 ygj icy fro hcx ygj wry	ygj icy
dyq mbi tpy ans3 pna hlq pgd lqx bhp tao lqx	pna hlq pgd
hlq ohx ans3 icy irg dyz wda hir hlq	icy irg dyz
lgh dyq ans3 nvc pgd hvu	nvc pgd hvu
rlt wda ans2 nvc fro lgh nvc pna	nvc fro
ans2 ohx wda ykm dyq	ohx wda
rlt dyq ans2 ykm ygj mbi	ykm ygj
ans1 god bhp	god
irg tpy ans3 nvc god dyz hlq hir	nvc god dyz
pna wda mbi ans1 tpy tao hlq wry	tpy
rfm fro ans2 irg lqx tpy lhm	irg lqx
ans3 hir hlq fro	hir hlq fro
dyz bhp ykm ans1 fro	fro
hir pna mbi ans3 fro nvc opa wda lgh bhp pgd	fro nvc opa
dyq ykm ohx ans3 bhp rlt pgd lgh rlt ygj lqx	bhp rlt pgd
wda ans3 opa bhp opa ygj wry	opa bhp opa
ygj hir wry ans3 hir pgd hvu	hir pgd hvu
icy lqx pna lhm ans2 bhp dyz ykm	bhp dyz
ans3 hlq rfm lqx ohx lgh opa ykm	hlq rfm lqx
tpy icy ans3 nvc opa tao hvu	nvc opa tao
wry bhp lqx nvc ans3 hcx kxd ohx mbi	hcx kxd ohx
pgd nms ans3 tpy god lhm nms hir god lqx	tpy god lhm
lgh ans3 nvc ohx mbi irg	nvc ohx mbi
tao ans3 lgh pna tao ygj	lgh pna tao
icy irg ans2 icy pna fro ykm hcx icy	icy pna
ans3 lqx icy icy pna	lqx icy icy
ykm ans3 tpy opa hvu	tpy opa hvu
wry ans1 irg rfm rfm rlt	irg
ygj hlq ykm bhp ans2 kxd tao hvu rlt lqx wda	kxd tao
mbi ygj ans2 lqx kxd bhp	lqx kxd
tpy god tpy dyq ans3 tao fro pgd dyq mbi	tao fro pgd
tpy pna nvc ans1 hlq wry pgd dyz	hlq
hlq ans2 pgd pgd lhm	pgd pgd
ans3 pgd rfm fro fro nms kxd	pgd rfm fro
icy ans2 opa hcx nvc	opa hcx
hlq tpy nms ans3 hvu hlq god	hvu hlq god
hcx lgh fro pgd ans2 wry nvc opa ykm opa	wry nvc
ans1 ygj lhm	ygj
pna ykm opa ans2 nvc bhp tao	nvc bhp
god wry opa ans2 dyz bhp pgd icy ygj mbi	dyz bhp
nms dyq tao ohx ans3 nvc mbi kxd lhm wda god	nvc mbi kxd
ans1 bhp pgd irg god dyz	bhp
opa dyz god ans1 hlq rlt lhm dyq bhp	hlq
ans2 opa hvu ykm rlt	opa hvu
hlq ans3 hlq bhp pgd pgd ohx kxd	hlq bhp pgd
ans1 hcx god hir ohx kxd	hcx
dyq icy dyq ans2 lgh irg rlt pna ohx pna	lgh irg
lqx hlq ans3 pna kxd rlt hcx dyz ohx	pna kxd rlt
ans1 hcx irg wry	hcx
dyz dyq kxd ans2 mbi opa dyq hlq	mbi opa
hlq ans3 icy hcx dyq pgd hlq	icy hcx dyq
icy rlt nms ans2 ykm ohx opa irg hir lhm	ykm ohx
ans3 icy ygj wry hcx kxd icy fro	icy ygj wry
dyq lgh ygj lgh ans2 icy lgh icy	icy lgh
irg ans3 hir mbi mbi lqx	hir mbi mbi
ans1 mbi rfm god	mbi
tao rfm kxd rfm ans2 irg tao	irg tao
hir lgh ans1 pgd wry pna irg	pgd
ygj irg hcx ans3 rlt hvu opa	rlt hvu opa
rlt nms tpy ans1 hvu dyq kxd	hvu
pgd dyq ans2 nms icy rfm	nms icy
hlq tao irg rfm ans2 lhm fro irg pna	lhm fro
rfm ygj ans1 bhp ohx tpy ohx hlq	bhp
dyz hlq nms tao ans2 ygj god rlt nvc	ygj god
lgh tpy hvu dyq ans2 rlt ygj opa rfm	rlt ygj
tao lhm nms ans1 pgd kxd pna icy lqx	pgd
tpy ykm tao kxd ans1 fro lqx	fro
rlt ohx pgd fro ans3 lhm lqx icy ykm dyq	lhm lqx icy
hvu ans1 nms	nms
ykm ygj tao ans1 wry kxd bhp	wry
nvc tpy ans3 nvc wry pna mbi tpy hvu	nvc wry pna
irg ans2 lgh hir tao ygj dyz	lgh hir
pgd tpy irg tpy ans1 wry opa hlq hcx pna	wry
dyz lgh fro ans2 lgh lgh wda	lgh lgh
nms irg ans2 lqx pna hcx lqx nms lgh	lqx pna
pgd kxd nms ans2 fro opa pgd	fro opa
opa god lhm hlq ans1 dyq kxd mbi wry	dyq
lhm ans2 rlt opa rlt ygj	rlt opa
kxd bhp ans1 hvu dyz hlq hlq	hvu
dyz lgh tpy ans2 hvu dyq pna rfm	hvu dyq
lgh wda ans1 ygj rfm lhm kxd lqx	ygj
ygj nms wry ans1 god nvc mbi hir	god
nms hir nvc god ans2 ygj rlt pna nms tao hcx	ygj rlt
fro pna ans3 opa ygj dyz icy icy rlt ygj	opa ygj dyz
ykm ans3 icy hcx fro bhp ykm hvu	icy hcx fro
lhm bhp lqx ans2 opa lqx nms tpy	opa lqx
ans3 mbi nvc lhm nms ykm dyq	mbi nvc lhm
ans1 ohx ygj	ohx
ohx tpy ans1 tao ohx ygj dyz ykm	tao
wda ohx hir ykm ans1 rfm icy tpy lgh	rfm
bhp ans1 ygj fro	ygj
ans1 bhp nvc nvc	bhp
nvc wry ans1 hir ygj lgh dyz tpy	hir
wry lhm wry bhp ans2 hlq dyq tao hvu rfm	hlq dyq
ygj ans1 bhp icy dyz ykm	bhp
ans1 wry	wry
hir hcx ans2 ohx lhm wry	ohx lhm
ans1 icy dyz rlt	icy
nvc hvu god god ans2 dyq ykm	dyq ykm
bhp pgd icy ans3 fro bhp bhp lgh	fro bhp bhp
ohx mbi hvu ans3 fro kxd nms bhp wda	fro kxd nms
pna hcx dyz hir ans3 lhm icy fro bhp dyz ohx wda	lhm icy fro
nms ans2 lqx dyq rfm lhm	lqx dyq
irg nvc ans3 ohx pna ygj	ohx pna ygj
ans2 tpy ykm hcx icy lgh nms	tpy ykm
wry mbi fro ans1 hir hir pgd	hir
ans3 dyz wry ykm	dyz wry ykm
hcx ans2 hir nms irg	hir nms
tao ans2 ohx lgh lqx pna	ohx lgh
opa lqx pna ans1 kxd hcx tpy	kxd
rfm pna ans3 wda rfm hlq tpy mbi	wda rfm hlq
tao hir lhm ans2 kxd fro pgd	kxd fro
rlt rfm lgh ans2 pgd hir	pgd hir
opa dyz ans3 hvu ykm hvu hlq hvu bhp fro	hvu ykm hvu
icy ykm kxd pna ans3 irg pgd tpy tpy hir	irg pgd tpy
hlq tao ans1 dyq lgh opa hlq	dyq
ans3 kxd nms pgd	kxd nms pgd
lqx bhp ygj ykm ans3 hvu wry kxd hvu ykm	hvu wry kxd
nms ykm lhm kxd ans2 opa hcx ykm lqx	opa hcx
ans1 dyq hir wry	dyq
lgh fro hlq ans2 hvu pna tpy	hvu pna
lgh ans3 dyz icy rfm irg bhp hcx hvu	dyz icy rfm
ans2 rfm icy hvu pgd	rfm icy
ans3 nms tao ykm bhp god lhm hir	nms tao ykm
ans1 lqx pna	lqx
ans2 lgh opa ykm god	lgh opa
tpy fro opa pna ans1 mbi hlq tao	mbi
nvc kxd ans2 lqx tao pgd pgd dyz	lqx tao
ans1 pna	pna
ans1 bhp	bhp
lgh ans3 icy tpy lqx ykm	icy tpy lqx
icy lhm pgd ykm ans2 ohx hvu ygj	ohx hvu
lqx lqx ans3 lgh lqx god god	lgh lqx god
ans3 opa rfm rlt	opa rfm rlt
nms ans1 hlq ohx tao	hlq
ans1 tpy dyz god hvu	tpy
mbi hcx hvu ans3 hlq wry bhp tpy god	hlq wry bhp
irg hcx ans2 bhp pna icy dyz nvc bhp	bhp pna
rfm fro ans3 kxd lgh hir kxd ykm nvc tpy	kxd lgh hir
pgd ans1 bhp hvu pgd	bhp
nms ans3 lhm rfm lqx icy irg	lhm rfm lqx
lhm ans2 nvc hcx mbi	nvc hcx
wry ans1 pna	pna
rlt ans2 kxd pna ygj fro bhp	kxd pna
hlq ans3 wry lgh god lqx	wry lgh god
pna tao hvu wda ans1 wda mbi nms hvu fro	wda
nms ans2 rlt mbi	rlt mbi
fro pgd ans3 rlt wry hcx tpy wda	rlt wry hcx
opa hlq dyq ans2 lgh hvu irg	lgh hvu
rfm ohx mbi pgd ans2 dyq lqx lhm	dyq lqx
wda ans3 tpy nms rlt hir tao rlt	tpy nms rlt
lhm ans2 wry ykm irg dyq	wry ykm
lhm ohx god lqx ans1 bhp ykm rfm	bhp
pgd hlq dyq tao ans3 mbi god icy	mbi god icy
fro icy bhp ans2 lgh icy pna tpy hlq	lgh icy
nvc fro ans1 lqx icy bhp	lqx
opa ygj ans1 irg mbi	irg
hvu ans2 pgd tpy wda lqx hcx	pgd tpy
irg ans3 wry bhp mbi ohx ykm	wry bhp mbi
hcx ohx ans1 mbi	mbi
hvu hvu ans3 fro tpy nvc	fro tpy nvc
ykm hlq lqx mbi ans3 dyq opa icy hvu god	dyq opa icy
lgh pna hcx ans1 wda	wda
lqx ans3 rlt dyq god pna	rlt dyq god
pna dyq nvc ohx ans3 mbi lqx pna pna opa tpy	mbi lqx pna
wry dyq tao ans1 hcx	hcx
irg ans2 nms mbi	nms mbi
irg lgh pgd ans1 tao ohx	tao
ans3 tpy rfm rlt hlq rlt lgh god	tpy rfm rlt
ohx lhm opa wry ans1 fro dyq	fro
hlq icy ans2 mbi dyz ygj lhm hcx tao	mbi dyz
ans3 opa opa pna	opa opa pna
nvc hcx tpy ans1 pna	pna
kxd tpy god ans2 mbi ykm ohx opa irg pgd	mbi ykm
rfm rfm dyq icy ans1 nms lhm	nms
hlq nms bhp ans3 fro lgh nvc irg opa opa	fro lgh nvc
opa bhp kxd ans2 fro tao	fro tao
lqx mbi tpy hvu ans3 wda lhm pgd ygj	wda lhm pgd
lgh lhm kxd ans2 kxd ykm fro rfm	kxd ykm
ans3 ykm pna irg wry opa lhm	ykm pna irg
opa mbi dyz tpy ans2 lqx hcx	lqx hcx
ans3 rfm rfm hlq lqx	rfm rfm hlq
ans3 nvc fro wry rlt rlt kxd	nvc fro wry
hvu nvc fro ans3 tpy nms icy hvu bhp bhp hcx	tpy nms icy
ans3 lhm icy lgh dyq ykm pna	lhm icy lgh
ans3 wda hcx lhm ohx lqx rlt mbi	wda hcx lhm
hcx lhm hvu wry ans3 rlt irg rlt tpy dyq opa	rlt irg rlt
ans2 rlt ykm	rlt ykm
hcx lhm irg dyz ans1 ygj	ygj
irg ans2 tpy rlt wry hcx rlt fro	tpy rlt
dyq wda dyq hir ans2 lgh dyq nvc pna	lgh dyq
hlq ykm wry ans1 tpy	tpy
ykm ans2 wry irg irg tao nvc	wry irg
tpy tao hlq ans3 nms lgh tao	nms lgh tao
ykm hcx ygj ans1 tao rlt icy irg hir	tao
ykm ans2 tpy nvc dyz	tpy nvc
ans3 pna ykm pgd ykm dyz hlq opa	pna ykm pgd
opa ohx rlt ans1 hir	hir
pgd ans1 nvc	nvc
mbi ans3 hir dyq lhm irg nvc tao	hir dyq lhm
ans1 ohx lgh fro	ohx
bhp hcx ans3 mbi tao kxd rlt dyq	mbi tao kxd
rfm wry hvu ans1 tpy	tpy
wry wda god ygj ans2 hcx lqx tpy pgd nvc	hcx lqx
lqx dyq ans2 icy hir	icy hir
ans2 hir tpy dyz nms hvu lqx	hir tpy
god opa mbi pna ans1 lhm	lhm
bhp dyz ygj ans2 lhm fro ykm	lhm fro
ans1 hvu hlq god rlt	hvu
tao nms god ans2 lqx god fro	lqx god
wry hlq ans3 mbi tao pna hvu	mbi tao pna
wda hlq ohx ans3 hlq hir fro lgh mbi nms	hlq hir fro
ykm tpy hvu ans1 hvu nms	hvu
lgh ykm ans2 rfm lgh	rfm lgh
opa irg ygj ans1 tpy	tpy
ans3 rlt hvu ykm icy ykm wry	rlt hvu ykm
lgh rfm fro tpy ans2 tao ohx ygj icy ygj ohx	tao ohx
tao rlt mbi ans1 irg hir hcx irg	irg
ans3 hlq nvc god lhm pgd	hlq nvc god
wda ans2 mbi icy nms	mbi icy
mbi irg ykm ans1 opa rfm rlt pna	opa
hvu lhm nms ans3 lhm rfm god opa fro	lhm rfm god
ygj lqx opa ykm ans1 lqx dyz lgh wry wda	lqx
pgd dyq ans3 wda dyq kxd hvu lhm hlq	wda dyq kxd
ans2 irg dyq dyz pgd rlt	irg dyq
hlq tao kxd dyz ans1 dyz hvu mbi	dyz
hvu ohx ans3 irg pna pna	irg pna pna
pgd hir ans1 ohx rlt hcx irg bhp	ohx
hcx lqx pgd ykm ans2 ohx icy	ohx icy
wry hvu ans3 nms kxd irg dyq	nms kxd irg
mbi lhm lgh ans2 ohx dyz hir ygj nms mbi	ohx dyz
pgd wda dyz ans2 rlt icy	rlt icy
pna lgh tpy dyz ans2 tpy tao hcx rlt mbi ykm	tpy tao
lqx mbi bhp ans3 rfm hir pgd	rfm hir pgd
kxd ans2 rfm kxd mbi hir pgd ohx	rfm kxd
ykm rlt rfm ans2 pgd dyq rfm dyq hlq	pgd dyq
dyz ans3 opa hlq lqx	opa hlq lqx
pna lgh ans2 opa hir rlt	opa hir
rfm rlt bhp ans2 lgh nms irg dyz kxd fro	lgh nms
hlq nms opa hlq ans1 ykm irg ohx	ykm
ykm kxd tpy pna ans1 bhp rfm	bhp
ans3 mbi dyz ykm hcx god	mbi dyz ykm
kxd nms ans2 ykm rfm hcx opa kxd	ykm rfm
wry bhp icy irg ans2 opa hcx irg rfm	opa hcx
ans2 lgh wry hlq hlq ykm	lgh wry
dyz pna ans3 icy lqx wry god rfm lqx kxd	icy lqx wry
hir ans2 hcx nms lhm bhp	hcx nms
hvu rlt hlq nms ans3 nvc lhm dyz nvc rlt wry tao	nvc lhm dyz
lhm dyz ans2 icy lgh icy nvc bhp lgh	icy lgh
ans1 hcx nms	hcx
god rlt hlq ans3 hvu nms bhp kxd	hvu nms bhp
nvc ans3 tao fro hcx wry ohx lhm ohx	tao fro hcx
lgh ans3 wda ykm rfm	wda ykm rfm
rfm nms nvc tao ans2 bhp hlq bhp tao hvu lgh	bhp hlq
ans3 rfm tpy wry dyz hcx mbi	rfm tpy wry
ygj hcx hlq mbi ans3 lhm lqx rlt pgd tao rlt	lhm lqx rlt
mbi opa opa rfm ans1 lgh dyq dyq hlq	lgh
ykm irg hcx rfm ans2 ygj hir lqx kxd mbi	ygj hir
fro dyq ans1 icy	icy
irg ans2 opa god	opa god
tao dyq hvu icy ans3 ygj irg ygj dyq	ygj irg ygj
ans1 tao wry mbi ygj ygj	tao
ans1 wda tpy hir wry opa	wda
lgh ans2 hvu nvc lhm god tpy	hvu nvc
dyz lqx lgh ans3 nms ygj lqx god hlq kxd	nms ygj lqx
ans1 kxd lhm ykm tao dyz	kxd
rlt tpy ans2 dyz mbi god kxd tao ygj	dyz mbi
ans1 hlq god ygj	hlq
ans2 tao hlq rlt dyq opa mbi	tao hlq
opa rfm hlq ans1 ohx nvc pgd	ohx
nms ans3 irg hvu kxd wda	irg hvu kxd
fro nms opa ans3 hlq wda lgh kxd	hlq wda lgh
ans2 ohx hlq icy rlt	ohx hlq
tpy ans3 pna nms rfm ygj	pna nms rfm
ans2 nvc kxd lhm rfm nms	nvc kxd
ans2 dyq rlt wry rlt rlt ohx	dyq rlt
ygj ygj ans3 dyq rfm ohx rfm hvu pna	dyq rfm ohx
hcx nvc lgh ans3 icy rlt nms	icy rlt nms
ygj lhm ans2 dyq opa tpy lgh dyz	dyq opa
wry lgh tao ans1 lgh ygj hvu god opa	lgh
ans3 opa hvu irg kxd	opa hvu irg
ans2 tao opa bhp	tao opa
irg ans3 nvc ohx tao fro rfm hcx	nvc ohx tao
hcx pna nvc ans3 mbi hcx kxd rfm	mbi hcx kxd
ans3 nms pgd pgd	nms pgd pgd
rlt nms ans3 god pgd lgh rlt fro nms hir	god pgd lgh
ohx pgd ans1 rlt icy rfm pgd	rlt
nvc hcx ans2 irg wda hlq rfm ohx kxd	irg wda
ans1 icy wda wry	icy
tpy bhp bhp hir ans3 god pgd ygj lqx	god pgd ygj
wry irg ygj ans3 icy lqx ygj wda fro god	icy lqx ygj
hcx lqx ans2 nms pna nms ykm ohx fro	nms pna
nms tao ans3 hvu ykm lhm	hvu ykm lhm
ans1 opa wda	opa
rlt kxd ans3 dyz rfm irg	dyz rfm irg
irg ykm ans2 rfm lqx hlq pna	rfm lqx
dyz lgh ykm ans3 lhm irg lhm kxd nms	lhm irg lhm
ans3 pgd hvu hcx	pgd hvu hcx
tao ans2 pna irg fro fro fro pna	pna irg
rlt hir nvc ans1 tpy ykm ohx lgh kxd	tpy
rfm god fro kxd ans3 rfm dyz ygj lqx opa ykm rlt	rfm dyz ygj
god nms dyz fro ans2 pgd hlq opa	pgd hlq
lqx rlt ans3 tao dyq pna fro lhm	tao dyq pna
hcx lqx nvc ans1 hir ygj ohx ygj	hir
ykm nms irg ans3 nvc dyq rfm	nvc dyq rfm
dyq mbi kxd god ans2 rlt nms	rlt nms
hlq ans3 lhm god dyz lqx icy	lhm god dyz
ans1 wry lqx ygj	wry
hir ans3 opa nvc ohx wry hvu rfm icy	opa nvc ohx
dyq nms wry ans2 ohx irg wry tao	ohx irg
pna wda ans2 wry wry nvc wry	wry wry
lgh fro ans1 hlq icy pna rfm bhp	hlq
fro irg icy ans1 irg rlt hir wry fro	irg
ygj ykm wry ans3 tao tpy irg lqx	tao tpy irg
ygj ans3 mbi hvu wry hlq pgd irg	mbi hvu wry
bhp tpy wda ans2 hir pgd tao rfm	hir pgd
ans3 bhp hir ykm rlt mbi	bhp hir ykm
fro rfm nms ohx ans1 rlt hir tao	rlt
dyz hcx ans1 tao icy ygj hcx fro	tao
ans3 wry irg lqx bhp opa	wry irg lqx
ans3 opa rfm hcx nvc ykm	opa rfm hcx
lhm fro ygj tpy ans1 nvc tao	nvc
god tao ans3 lgh rfm pgd	lgh rfm pgd
tpy ans3 dyz dyq opa fro icy	dyz dyq opa
ans2 nms lhm icy dyq dyq icy	nms lhm
tao ans3 dyz hcx pgd lhm hlq wda lgh	dyz hcx pgd
ykm ohx god ans1 wry lgh	wry
icy ans3 fro irg lhm rlt rlt dyz lgh	fro irg lhm
wda hvu ans2 bhp tao pgd god opa fro	bhp tao
ygj wry ans2 fro rlt tao	fro rlt
ykm ans3 wda fro rfm ykm lgh tao lgh	wda fro rfm
mbi pgd icy god ans2 opa hcx god hcx nvc	opa hcx
ohx pna irg ans1 mbi wda	mbi
icy hir bhp dyz ans2 opa wry god	opa wry
dyz lhm ans1 opa pna pna dyz irg	opa
dyq fro opa ans2 lqx bhp pgd pna dyq fro	lqx bhp
god wry lgh icy ans1 wry dyq mbi	wry
opa fro god ans3 dyq fro icy	dyq fro icy
ans1 bhp lqx bhp ygj	bhp
nms lhm ygj lqx ans3 ohx hcx nvc nms irg rlt dyq	ohx hcx nvc
hcx hvu hvu ygj ans3 ohx hcx hcx irg fro	ohx hcx hcx
dyq hcx ans1 nvc dyq rfm ykm lhm	nvc
icy kxd god ans1 ygj ohx	ygj
dyq ans2 nvc hvu wry ohx dyq	nvc hvu
ans2 lhm nvc lqx icy	lhm nvc
kxd nvc ygj mbi ans1 icy wry ohx wda	icy
ygj dyz nvc ohx ans3 dyz wry bhp pna opa wry hlq	dyz wry bhp
bhp lgh ygj ans2 ohx wda lgh lqx god	ohx wda
pgd ans2 wda hlq bhp	wda hlq
dyq rfm god ygj ans1 lgh pna ygj nvc	lgh
ykm bhp ans1 hir fro tpy	hir
ans3 pgd bhp fro	pgd bhp fro
opa rlt ohx pna ans1 rlt	rlt
hlq ans2 bhp nms	bhp nms
pgd rlt pna ans2 dyq hcx mbi tpy	dyq hcx
bhp dyz hlq fro ans2 ykm opa hcx wda rlt lgh	ykm opa
ans1 hvu	hvu
irg mbi hvu ykm ans2 ohx kxd irg opa tpy	ohx kxd
dyq hlq ans2 dyz dyz hvu hcx	dyz dyz
pna rlt kxd ans2 god mbi nms icy icy pna	god mbi
ans2 bhp pna pna rfm	bhp pna
god tao lqx ans1 mbi god dyq	mbi
tpy ans2 fro fro rlt tao ohx opa	fro fro
pgd ohx dyz wry ans1 tpy rlt	tpy
tao fro dyq dyz ans3 opa god wda hlq irg ykm pgd	opa god wda
hcx wry ans3 kxd kxd lgh bhp hir rlt lqx	kxd kxd lgh
nms ans3 lgh icy lhm	lgh icy lhm
hcx ans3 opa wda pna	opa wda pna
icy tao pna nvc ans1 hcx hcx dyq irg rlt	hcx
opa ans2 fro bhp ygj ykm	fro bhp
nms wda ans2 hlq wda dyz	hlq wda
tao ans2 hlq ygj wry pna rfm	hlq ygj
ans1 fro hvu pna	fro
wda rlt opa fro ans1 hvu	hvu
ans1 irg tpy	irg
rlt ans1 god wda dyq ohx	god
wda lhm ygj rfm ans1 icy	icy
lgh nvc tao kxd ans2 wda ohx mbi	wda ohx
hlq kxd irg pna ans1 dyq god pgd dyz hlq	dyq
lqx dyq ohx ans2 nms lqx tpy irg bhp lqx	nms lqx
wry ohx dyq wda ans2 ykm opa irg rlt	ykm opa
lqx ykm ans3 pna hir ohx hlq	pna hir ohx
ans2 hlq lhm tpy pna icy pna	hlq lhm
tao bhp pgd ans2 wry ykm rlt rlt hcx irg	wry ykm
ans2 irg rfm god tao	irg rfm
pna ykm ygj ans1 irg ygj dyz tao hir	irg
ans1 rfm hvu pna wry	rfm
hvu ykm fro ans1 rfm hlq tao ygj	rfm
tpy ans1 ykm ygj tpy hcx god	ykm
rfm nvc lqx ans3 lgh fro rfm kxd kxd	lgh fro rfm
ans1 hvu wry	hvu
ans3 wda hlq dyz lqx kxd tpy	wda hlq dyz
lhm lhm ans3 pgd god ohx lgh irg opa wry	pgd god ohx
dyq tpy pna wda ans3 bhp icy ykm dyq opa	bhp icy ykm
dyq nms hvu ykm ans2 opa god	opa god
ans1 bhp wry	bhp
hcx lhm ans1 wry irg dyz wda lgh	wry
ohx wry ans3 hir tao hcx dyz icy	hir tao hcx
hlq fro dyq irg ans1 hlq wda	hlq
ans1 hlq wda dyq	hlq
nms icy ans1 pgd	pgd
ans3 pna mbi ykm	pna mbi ykm
lqx ykm hir rfm ans1 lgh tpy lhm rlt	lgh
lqx lhm ans2 rlt tpy	rlt tpy
bhp kxd ans1 lhm bhp hlq fro wda	lhm
pgd lgh nms ans3 lhm pgd hlq irg tpy nms	lhm pgd hlq
bhp ygj dyz pgd ans1 ykm rfm lgh	ykm
irg hir kxd lqx ans2 opa dyz nvc	opa dyz
rfm hcx ans1 lhm irg nvc	lhm
opa icy ans2 mbi pna dyq	mbi pna
ans2 ygj pna opa nms	ygj pna
ans2 ygj ygj bhp tao lqx wry	ygj ygj
tao ans1 bhp wda rfm	bhp
ans2 lqx pna	lqx pna
pna nms rfm ans2 mbi lhm ygj tpy mbi	mbi lhm
mbi pgd tao ans2 fro rlt hcx	fro rlt
ans2 hlq fro hvu hcx fro rfm	hlq fro
wda ans3 mbi nms pna	mbi nms pna
tao pgd ans2 lqx fro mbi bhp dyq	lqx fro
kxd pna rfm wda ans1 tpy god	tpy
hir ans3 tao tpy rlt dyz	tao tpy rlt
wry ans3 wda dyz lgh lgh wda dyq wda	wda dyz lgh
ans2 kxd opa tpy ohx opa kxd	kxd opa
ans2 nvc hcx ygj bhp	nvc hcx
nvc ohx hvu ans2 mbi rfm pna rfm tao	mbi rfm
wda ans2 hvu ohx irg hlq nvc wda	hvu ohx
ohx wda god ans1 icy pna bhp rfm pgd	icy
opa rfm icy nms ans2 hvu lqx fro icy tao opa	hvu lqx
ans3 rlt rfm pna lgh icy bhp	rlt rfm pna
pna opa dyq lgh ans3 rlt rlt ykm ykm	rlt rlt ykm
hcx ans3 lhm kxd god ohx kxd wda	lhm kxd god
pna ans1 hlq pna	hlq
rlt bhp bhp lqx ans1 rlt tao	rlt
icy mbi bhp ans3 rlt wry hlq ykm tpy pna	rlt wry hlq
rfm rlt ans3 hcx fro lhm hvu	hcx fro lhm
tao lgh lgh mbi ans3 irg irg pgd lqx dyz icy	irg irg pgd
ans1 hlq mbi lqx ohx	hlq
opa tpy ans2 ykm ygj hlq ohx wda nvc	ykm ygj
lgh god nms mbi ans2 hir tpy rlt hcx tpy irg	hir tpy
god opa dyq ans1 tpy hvu god tao hcx	tpy
ygj ans1 nms wry	nms
rfm wry ans1 nvc hlq tpy kxd	nvc
ans2 pgd wda	pgd wda
lhm hcx nms lhm ans1 ygj bhp hir kxd opa	ygj
pgd dyq lhm ans2 lqx kxd bhp wda lgh lqx	lqx kxd
hlq ans2 tao icy	tao icy
ygj opa pna dyq ans1 dyq	dyq
ans3 hvu ohx wda	hvu ohx wda
irg irg hvu ans1 opa icy rlt	opa
nms hcx fro mbi ans1 tao ohx mbi icy ygj	tao
tao pgd pgd ans1 hvu god icy fro opa	hvu
lgh rfm bhp ans3 opa kxd bhp tpy pgd rlt mbi	opa kxd bhp
tao hcx rlt ans3 pgd rlt lhm	pgd rlt lhm
lhm ans2 tao god wry	tao god
ans1 ykm rfm bhp wry	ykm
ohx nms nms ans3 god ygj icy tao opa	god ygj icy
pgd pgd ans3 kxd lgh nvc	kxd lgh nvc
icy dyq nvc ans1 irg nms tao nvc dyz	irg
ygj tpy icy ans2 lgh nvc dyq	lgh nvc
ans2 bhp ohx nvc hcx	bhp ohx
ans2 mbi kxd kxd ygj	mbi kxd
hlq mbi ans2 lqx hir	lqx hir
hvu ans3 tao lhm bhp	tao lhm bhp
lqx wry fro ans3 icy fro hir ygj	icy fro hir
fro fro ans1 irg tao hlq ykm lhm	irg
lhm god hlq ans3 tpy hlq ohx ykm wry ygj bhp	tpy hlq ohx
irg dyz hvu ans3 lqx rlt hir god	lqx rlt hir
wry rfm ans2 dyq lgh ygj nms hir	dyq lgh
nvc hvu nms rlt ans3 wda lqx hvu hcx	wda lqx hvu
ans3 opa god pgd fro	opa god pgd
pgd nvc irg bhp ans3 god ohx hlq hir god icy hlq	god ohx hlq
nms pna hir fro ans2 wda rfm hlq	wda rfm
lgh ans3 nvc irg icy	nvc irg icy
rfm hvu lgh ygj ans3 opa nvc tpy wda hvu	opa nvc tpy
ohx ans1 god dyq irg fro	god
ans3 hlq fro nms	hlq fro nms
kxd rlt dyq wry ans3 kxd wry god lgh rfm kxd hcx	kxd wry god
dyz rlt ans3 opa bhp wda opa	opa bhp wda
lgh ans1 ykm tpy	ykm
hir rfm ans3 lgh dyz nms nms	lgh dyz nms
god lqx ans1 hir	hir
ygj hlq rlt kxd ans2 mbi irg	mbi irg
nvc ykm nvc ykm ans1 ykm lgh hir wry	ykm
wry mbi ans3 tao icy tao	tao icy tao
lhm hir lqx nms ans3 fro lgh nvc opa	fro lgh nvc
fro ans1 ykm kxd hir	ykm
ans3 mbi irg bhp	mbi irg bhp
icy opa lgh ans1 wry icy hlq pgd wda	wry
ans2 hlq ygj lhm rlt	hlq ygj
ohx tao irg ans2 pgd lgh dyz pna	pgd lgh
ans3 kxd lhm tao lgh ohx lgh fro	kxd lhm tao
dyq ans1 wry mbi god	wry
bhp ans2 kxd irg nms ykm	kxd irg
mbi bhp ygj ans2 lgh tpy lgh tpy god wry	lgh tpy
rlt ans1 wry hlq pgd pna bhp	wry
ans2 fro dyq	fro dyq
rlt lqx tpy ans2 god lqx kxd	god lqx
wda fro ans1 lhm god mbi	lhm
ans2 ykm hcx wry	ykm hcx
ans3 god mbi pna pgd tao ykm ygj	god mbi pna
ohx irg icy ans3 pgd hcx icy nms	pgd hcx icy
nvc bhp ans1 pna ykm	pna
bhp lhm ans2 bhp hlq nvc fro	bhp hlq
mbi ans3 wry lqx dyq wry lgh	wry lqx dyq
hir pna ans1 ohx dyz	ohx
ans1 tpy pna ohx ygj nvc	tpy
tao ygj dyq ans1 opa	opa
tao ans3 mbi irg bhp wda	mbi irg bhp
ohx hir rlt fro ans3 tpy lhm pna	tpy lhm pna
fro tpy nvc wda ans3 icy kxd hlq	icy kxd hlq
wry god ans2 tpy nms tpy	tpy nms
hcx rfm ohx pna ans1 lhm rlt rlt dyz bhp	lhm
pgd dyq ans2 god kxd ohx hcx god dyz	god kxd
ykm irg opa fro ans2 opa god irg	opa god
ans1 pna	pna
hir wda ans3 ykm hlq fro wda ygj	ykm hlq fro
hir hcx lgh ans2 lqx ohx rlt ohx lqx	lqx ohx
pna ans3 hcx tao tao	hcx tao tao
ans3 lqx ygj hir irg	lqx ygj hir
mbi bhp hlq ans3 ohx lhm lhm	ohx lhm lhm
tpy ans3 dyz pgd dyz nvc tpy ygj lhm	dyz pgd dyz
ans1 hcx ykm lgh	hcx
ohx kxd dyq pgd ans1 lqx tpy fro	lqx
kxd kxd pgd nms ans2 lgh dyq irg rlt fro	lgh dyq
pna ykm kxd ans2 pgd hvu pna tpy	pgd hvu
pgd rlt wry hvu ans1 nvc rfm rfm mbi	nvc
hir dyz rlt ans2 tao lhm tao pgd	tao lhm
irg wda ans1 icy bhp ohx lgh fro	icy
wry ans1 hvu bhp bhp ygj	hvu
pna ans2 dyq hvu lqx	dyq hvu
kxd kxd ans3 god kxd tpy ohx	god kxd tpy
pgd ans1 pgd nvc	pgd
rlt lhm tao mbi ans3 pgd kxd hir rlt	pgd kxd hir
wda rlt icy ans1 hcx dyz ykm ygj god	hcx
ans2 nvc hcx icy rlt god	nvc hcx
ans2 tpy lqx	tpy lqx
hcx ans3 pna icy lhm hvu ohx pna wry	pna icy lhm
dyq ans3 dyz fro pna ygj hlq ykm ygj	dyz fro pna
icy nms rfm hir ans3 mbi irg icy lqx bhp	mbi irg icy
hvu ans2 fro fro bhp	fro fro
fro ans3 bhp lhm lgh hvu lhm hir god	bhp lhm lgh
pna ykm ans2 irg god nvc irg	irg god
ans1 hvu	hvu
god pgd kxd ans2 tpy opa pgd god ohx opa	tpy opa
dyz ans2 kxd bhp lqx ygj tao	kxd bhp
hcx ans2 ohx ygj ygj lgh kxd	ohx ygj
pna ans2 ygj opa nms	ygj opa
rfm wry ykm ans2 ygj lhm wda ohx	ygj lhm
dyq irg kxd ans3 dyz dyq nms hcx mbi irg	dyz dyq nms
opa nms lqx nms ans1 wda dyq god	wda
ans3 lqx lgh kxd	lqx lgh kxd
ygj ygj ans3 wda rlt nms hir ygj god ohx	wda rlt nms
pna ohx lqx ans3 tpy pgd rlt pgd pgd lqx	tpy pgd rlt
bhp irg ans2 opa wda tao opa ygj lqx	opa wda
hlq hvu ans1 rfm hir irg ohx	rfm
bhp dyq ans3 pna pgd hir ygj wry	pna pgd hir
lhm bhp ans3 rfm nvc tao god wry	rfm nvc tao
lqx ans1 dyq opa wda nms lhm	dyq
ans2 lqx wda	lqx wda
wda ygj ans1 rlt ygj hcx	rlt
icy pna pgd dyz ans2 hvu hlq icy nms tao fro	hvu hlq
ans2 pna tao tpy icy pgd ohx	pna tao
hir ans2 lqx dyq wda hcx hlq nms	lqx dyq
rfm wry tpy mbi ans3 ygj dyz wda mbi rfm lgh god	ygj dyz wda
ykm dyq nvc wry ans2 wry fro	wry fro
mbi tao god lgh ans2 pna hvu lgh nvc tpy	pna hvu
lgh ans1 pna wry pna mbi fro	pna
dyq ans3 dyz tao ohx	dyz tao ohx
lhm ans2 god tpy irg	god tpy
ykm hir ans3 hcx lqx pgd icy lgh god	hcx lqx pgd
bhp hvu nms ans3 dyz dyz pgd	dyz dyz pgd
ans1 ohx	ohx
ans3 fro wda ygj dyq	fro wda ygj
hlq ans2 nvc hir nms ohx dyz	nvc hir
bhp pna tpy ans3 pgd tpy icy ygj	pgd tpy icy
rlt ans2 rfm lqx god dyq lgh nvc	rfm lqx
lgh ykm tpy ans1 ohx kxd	ohx
ans1 dyz nms	dyz
hvu hvu fro ans2 rfm kxd rlt bhp irg	rfm kxd
icy wry ygj ans2 lgh lqx hvu tao	lgh lqx
lgh tao ans1 mbi	mbi
pgd icy hcx god ans1 fro mbi wry	fro
hcx rlt lgh kxd ans3 icy icy opa wda kxd kxd irg	icy icy opa
ans2 ohx irg irg pna	ohx irg
lgh tao ans1 fro rlt ygj	fro
hvu ans1 dyq hcx ohx hvu	dyq
hir ans2 nvc rlt opa hir wda	nvc rlt
ans1 tao pgd	tao
nvc lhm bhp ans2 fro fro wda opa	fro fro
rlt pna ans2 ohx nms ykm	ohx nms
hvu kxd god tpy ans3 wda hlq lhm fro	wda hlq lhm
fro ans1 dyq hlq rfm rlt mbi	dyq
pgd ykm ans1 opa god pna hcx dyz	opa
nvc icy ygj ans3 lhm ygj pna pgd kxd	lhm ygj pna
pna wry ans1 nvc dyq	nvc
ans2 lgh fro ohx pna ygj wda	lgh fro
mbi ygj ohx ans1 hlq	hlq
ans3 tao fro dyq mbi wry hlq	tao fro dyq
ans1 ygj opa	ygj
lgh nms nms ans1 wda lgh lgh	wda
rfm lhm ygj lgh ans3 tpy ohx lhm lhm	tpy ohx lhm
lqx ohx kxd hir ans3 ykm opa ykm lgh	ykm opa ykm
lqx god rfm ans2 fro kxd	fro kxd
god ans1 opa	opa
lqx ans2 lhm dyz dyz	lhm dyz
ans3 ygj pna dyq hcx lqx hlq	ygj pna dyq
mbi nvc ans2 ykm dyq mbi	ykm dyq
lhm lhm dyq ans3 wry ohx lgh	wry ohx lgh
pgd mbi ohx icy ans3 irg tao fro opa ykm bhp rfm	irg tao fro
rfm mbi ans3 kxd rlt ygj icy hlq fro hlq	kxd rlt ygj
hcx god ans2 hir irg mbi hcx	hir irg
bhp lgh hvu pgd ans3 lhm opa lgh hir	lhm opa lgh
hir hlq lqx wry ans2 mbi lqx wry hvu	mbi lqx
lgh hcx lqx rlt ans2 pna icy hir dyz tao	pna icy
mbi lgh ans2 tpy kxd	tpy kxd
hlq lgh nms ans1 ykm wry kxd irg bhp	ykm
wry tao rfm hir ans2 ohx hvu ohx	ohx hvu
dyq lhm rlt opa ans1 bhp	bhp
ykm ans3 tpy pgd tpy pgd	tpy pgd tpy
dyz dyq fro ans2 rfm irg	rfm irg
tpy wry ans2 icy irg opa wda lhm	icy irg
ans3 lqx wry hcx lgh rfm lgh	lqx wry hcx
ans1 wry wda nvc dyq rfm	wry
wda ohx ans1 dyq nms mbi ohx nvc	dyq
lhm icy tpy ans3 opa wry lqx	opa wry lqx
wry irg hlq tpy ans1 irg	irg
ykm nms ans1 irg wda wda rlt	irg
hvu hlq wry ans2 tao ygj rfm	tao ygj
ans3 hlq pgd ohx icy dyz	hlq pgd ohx
mbi pgd ans1 lqx pgd	lqx
mbi opa hir irg ans2 pgd irg opa dyq bhp	pgd irg
nms lqx ygj ans3 mbi tao lhm ygj hlq lqx	mbi tao lhm
ans1 dyq pgd lgh hvu	dyq
ykm ans2 fro hvu	fro hvu
hlq lqx hvu ohx ans2 lhm nms rfm icy mbi dyq	lhm nms
hcx ans1 god icy kxd tao icy	god
wda lhm bhp god ans3 bhp ohx icy lhm hir lhm	bhp ohx icy
irg ans3 lgh god ohx ohx	lgh god ohx
god tpy ans3 rfm hlq nms wda icy pgd nms	rfm hlq nms
hvu lgh ans2 fro ygj rfm icy	fro ygj
wda lqx kxd icy ans3 irg nvc pgd nms nvc	irg nvc pgd
dyz ans2 god ygj	god ygj
rlt ykm ykm irg ans3 lhm rfm dyq kxd tpy	lhm rfm dyq
hir ygj ans1 bhp bhp lhm rlt wda	bhp
ans3 pgd bhp mbi dyz lqx	pgd bhp mbi
wry lgh hcx hcx ans3 rfm lqx tpy rfm ohx hvu hcx	rfm lqx tpy
ans2 pna lqx tpy wry tao	pna lqx
hir ans1 irg ygj tao hir tpy	irg
bhp ans3 pna irg nvc nms nvc hir icy	pna irg nvc
pna ohx pgd tpy ans2 nms kxd pna hvu	nms kxd
icy ans1 opa wda hlq	opa
wry wry ans3 bhp hlq rfm pgd wry wry tao	bhp hlq rfm
lgh mbi lgh hcx ans1 irg	irg
nvc hvu dyz lqx ans1 lgh wda pgd dyz	lgh
icy ans2 nvc ohx lgh nms dyq hlq	nvc ohx
tao wry hvu icy ans3 pna hcx lgh god kxd icy pgd	pna hcx lgh
ans3 rfm pna fro hvu hir pgd	rfm pna fro
rfm pna ykm ans3 hir hlq nms mbi hvu god ohx	hir hlq nms
ans2 pna hcx mbi ykm	pna hcx
ans2 hcx wda	hcx wda
lgh lqx nms ygj ans3 nms rlt fro irg	nms rlt fro
lgh fro hvu hlq ans3 pna bhp pgd nvc fro rfm dyz	pna bhp pgd
god opa ans3 dyz hlq nms lhm hvu	dyz hlq nms
lqx wry ans2 hcx fro dyq mbi irg	hcx fro
ykm rlt ans1 kxd	kxd
ans3 opa opa nms tpy	opa opa nms
hvu mbi kxd ans3 irg fro god pgd	irg fro god
nvc opa fro ans1 pna	pna
lhm lqx opa hcx ans1 rfm icy lhm	rfm
lgh hvu rlt ans2 tpy tao hir god ohx	tpy tao
god nvc ykm pgd ans3 pgd pgd tpy irg kxd	pgd pgd tpy
lqx ans1 pgd hvu lgh dyz wda	pgd
nms ans3 pgd fro hvu hir god lhm lgh	pgd fro hvu
ans1 lgh lqx rlt	lgh
lhm ans2 fro rfm irg	fro rfm
lhm dyz tpy ans1 dyz icy tao ohx tpy	dyz
tpy ygj icy bhp ans1 bhp hvu	bhp
ans3 ohx hvu pgd wda	ohx hvu pgd
pgd hvu ans1 hvu hcx dyq nvc	hvu
rfm tao kxd rfm ans1 mbi mbi nms	mbi
lqx opa ans3 dyq opa wda	dyq opa wda
wry lqx lhm hlq ans3 hlq bhp hcx wda	hlq bhp hcx
god ans3 pgd nms dyz	pgd nms dyz
fro lgh irg wry ans3 opa rfm pgd irg icy ohx dyz	opa rfm pgd
ans1 opa wda	opa
dyq fro opa ans3 pgd icy pgd tao fro mbi rlt	pgd icy pgd
ans2 hcx lhm nms nvc wry hvu	hcx lhm
wda ans2 nms mbi nvc	nms mbi
wda hcx ans1 fro hvu hir god lgh	fro
ans3 ohx pgd pgd rfm rlt ygj ohx	ohx pgd pgd
ans3 bhp opa nms tao rfm	bhp opa nms
hir lqx ans2 hvu rlt dyz	hvu rlt
rlt tpy ans1 dyz mbi hcx nms ykm	dyz
nms lqx mbi ygj ans1 hvu ykm nms	hvu
dyz ans3 hir tpy hlq lhm	hir tpy hlq
pgd ans1 rlt tpy	rlt
rfm rlt god ans3 pna mbi rfm irg dyq tao	pna mbi rfm
ans1 mbi tao	mbi
tao wry ans3 lqx nvc kxd lqx bhp rfm	lqx nvc kxd
pgd lhm rlt ans3 tao hlq dyq nms tpy	tao hlq dyq
nvc ans3 ygj rlt irg irg hcx mbi dyq	ygj rlt irg
dyq hlq rlt lhm ans1 wry tpy pna pna hcx	wry
tao ygj rfm ans2 rfm nvc fro	rfm nvc
ans2 wry dyz kxd nvc dyq	wry dyz
bhp opa wry ans2 tpy tao	tpy tao
irg lgh fro ans3 ohx fro tpy hlq	ohx fro tpy
ans3 tpy god lqx tao ygj fro	tpy god lqx
hcx ans3 ygj dyq tpy mbi bhp icy	ygj dyq tpy
wry hvu tpy pgd ans1 nvc	nvc
ans2 nms rlt ohx lhm rlt god	nms rlt
kxd nvc rlt pgd ans3 rlt dyq tpy	rlt dyq tpy
ans2 lqx fro dyz	lqx fro
tpy lgh ans1 irg icy wry hir lqx	irg
icy pna icy ans1 ykm rfm hvu hlq	ykm
god ans1 hvu opa dyq fro god	hvu
hvu ygj ans2 lgh tao icy fro hlq	lgh tao
rfm fro hlq ans1 lgh lgh	lgh
wda mbi god ans1 rfm	rfm
ans3 hlq god god wda dyz	hlq god god
lqx fro ans2 rlt nms ygj	rlt nms
nms hvu god ans2 irg icy	irg icy
hcx god nms irg ans1 kxd	kxd
god ykm ans3 opa rlt ohx	opa rlt ohx
tpy tao tao ans2 lqx icy wry icy	lqx icy
lqx nvc ans1 pgd dyz	pgd
ans3 lgh god god	lgh god god
pgd irg ans2 icy irg	icy irg
wda hlq opa rlt ans2 hlq lgh	hlq lgh
hlq wda ans3 lqx dyz hcx mbi god rlt	lqx dyz hcx
ans1 rfm	rfm
ans3 opa ohx lqx	opa ohx lqx
tpy lgh tpy ans2 hir hir	hir hir
ans1 wda wda rfm	wda
kxd icy ans2 pgd ygj tao hvu	pgd ygj
ykm tpy god ans3 god tao opa hlq irg lhm hir	god tao opa
hir ans1 hvu	hvu
mbi ans2 opa dyz lhm ohx rlt ykm	opa dyz
ans2 irg irg bhp	irg irg
ans1 hir hcx lgh god rfm	hir
ans1 hvu hir	hvu
hir ans1 bhp nvc	bhp
hvu pna ans3 pgd wry irg	pgd wry irg
ohx hcx dyq ans3 hvu wry dyq	hvu wry dyq
ans2 irg bhp	irg bhp
dyq hcx tpy lqx ans1 rfm	rfm
ans3 mbi fro nms bhp ygj	mbi fro nms
wda icy pna ohx ans2 rfm icy	rfm icy
wry hir icy ans1 hlq bhp	hlq
ykm ygj tpy ans1 fro pgd wry	fro
opa ans3 nms rfm lgh lhm irg lqx	nms rfm lgh
rfm irg god god ans2 pgd nms hcx irg nvc tpy	pgd nms
ykm lhm wry fro ans1 rlt	rlt
wry opa tpy pna ans3 lhm hlq dyq hvu	lhm hlq dyq
opa lgh ans1 nvc god	nvc
lqx icy nvc ykm ans1 ygj	ygj
opa lqx pna ans2 lgh ohx	lgh ohx
rlt hlq ans1 ohx	ohx
pna hlq bhp ans1 nms lqx icy irg	nms
hlq hlq ans2 wda hlq dyq	wda hlq
ygj ans3 pgd god irg pgd icy pgd irg	pgd god irg
lqx opa ans1 rfm lhm hir	rfm
rlt hlq ans3 rlt lgh hlq hcx ykm	rlt lgh hlq
lhm ygj hlq ans3 tao wry hir hlq wry	tao wry hir
pna ans3 dyz hir hcx hlq pgd	dyz hir hcx
hlq ans2 icy nvc dyq irg lgh hvu	icy nvc
ans2 hcx wda irg	hcx wda
ans1 nms nms ykm	nms
lgh ans1 tpy wry	tpy
opa ans3 pna dyq hlq	pna dyq hlq
kxd tpy bhp ans1 rlt rlt	rlt
nvc lgh ans2 kxd mbi ykm mbi hcx	kxd mbi
ans2 bhp opa lgh	bhp opa
mbi tao wry wry ans2 bhp hlq lqx hvu nvc	bhp hlq
lgh hvu ans3 ykm lhm rfm tpy nms nvc opa	ykm lhm rfm
hlq lqx mbi ans2 rlt kxd opa	rlt kxd
lqx lgh tao ans1 wry kxd hlq	wry
bhp mbi ans2 lqx bhp	lqx bhp
hir ans1 ykm nms	ykm
wda dyq ans1 tpy ykm dyq fro hvu	tpy
hcx tpy ans3 dyz hlq lqx nvc hlq mbi opa	dyz hlq lqx
wry ans3 rlt hcx mbi irg tpy kxd mbi	rlt hcx mbi
ohx ans3 rfm lhm nvc bhp lqx	rfm lhm nvc
ohx ans3 wry dyz hlq mbi tpy	wry dyz hlq
god dyz ans3 rfm dyq nvc icy lhm dyz	rfm dyq nvc
hlq wry hlq ygj ans3 bhp hlq hir	bhp hlq hir
hlq mbi ykm lhm ans2 god dyq tpy tao	god dyq
ans1 lqx ykm ohx lhm	lqx
bhp ans1 lgh	lgh
dyz nvc tpy hlq ans1 rlt pgd kxd wry pgd	rlt
lqx pgd ans1 rfm ohx rfm kxd tao	rfm
ans1 irg nms	irg
rfm pgd kxd ans3 pna ykm nvc	pna ykm nvc
nms ans2 god dyz	god dyz
lqx god hlq ans1 nms	nms
ygj ans3 nvc lgh hir kxd	nvc lgh hir
nms bhp icy ans2 hlq icy	hlq icy
tpy nvc ans3 god tao lgh	god tao lgh
ans3 fro hvu nms lqx bhp ykm	fro hvu nms
ygj hir ans1 rfm mbi	rfm
nms ans3 nvc tao pna hvu dyz	nvc tao pna
mbi hcx ans1 icy hvu	icy
wda dyz tpy rfm ans2 lqx tpy bhp nvc hir	lqx tpy
bhp pna dyz rlt ans3 irg hvu tpy icy pgd	irg hvu tpy
hir irg irg lqx ans1 fro nms	fro
ans2 rfm kxd lqx bhp	rfm kxd
ans2 kxd hir nms	kxd hir
lhm nms ans3 kxd dyz ohx nvc tpy	kxd dyz ohx
ykm dyq ans1 icy fro hlq	icy
wry ans3 mbi god ohx irg lgh nms wry	mbi god ohx
ans3 kxd lqx dyz hvu	kxd lqx dyz
rlt tao kxd ans3 ygj hvu ohx icy lhm hcx	ygj hvu ohx
ans3 wda lhm dyz hir rfm	wda lhm dyz
hvu hlq ykm ans3 kxd fro pgd	kxd fro pgd
ans2 tpy opa	tpy opa
lgh ans3 pgd opa rlt lqx hlq nvc ykm	pgd opa rlt
dyq dyz ans2 tao lhm hvu icy ygj ykm	tao lhm
hlq tpy ygj ans2 lqx mbi pna	lqx mbi
hlq nms opa ans2 tao dyq lgh ohx	tao dyq
dyq hlq hcx ans3 wda pna dyq	wda pna dyq
irg tao ans3 hvu pgd wry	hvu pgd wry
nms hir kxd god ans1 nvc wry dyz rlt fro	nvc
dyz ans1 wda tpy ykm god	wda
tpy wry nms ans3 wda mbi rfm	wda mbi rfm
hir wda rfm ans2 mbi pna kxd lgh pgd dyq	mbi pna
irg fro bhp ans3 icy lhm dyq pna lgh hcx ygj	icy lhm dyq
hcx hir pgd hvu ans2 ykm wry ohx rfm ygj dyq	ykm wry
lqx rfm ygj tao ans2 hlq pgd dyq mbi fro dyq	hlq pgd
ans1 fro	fro
ans2 mbi rfm fro hlq lqx	mbi rfm
ans2 god bhp irg ohx	god bhp
lhm kxd ans3 kxd dyz pna	kxd dyz pna
ygj ans3 ygj god lgh irg lqx lhm	ygj god lgh
tao rfm ans1 lhm ykm lgh pna ohx	lhm
tao opa dyq hir ans3 opa pna bhp nms nvc hvu wry	opa pna bhp
ykm ykm hcx bhp ans1 ykm hcx fro pgd tao	ykm
ans3 bhp tao icy lqx dyq wda dyz	bhp tao icy
dyz tpy pna lgh ans3 nvc hcx nvc	nvc hcx nvc
ans1 lqx lhm kxd	lqx
ans2 rfm pgd god	rfm pgd
rfm mbi opa hlq ans2 nms kxd fro	nms kxd
icy hir dyq icy ans1 hir kxd mbi lqx god	hir
hlq tpy lqx kxd ans3 mbi mbi ohx pna ygj tpy wda	mbi mbi ohx
dyz tpy god opa ans1 ygj opa	ygj
nvc rlt ykm rlt ans3 ohx wda pna hlq bhp	ohx wda pna
rfm wda ans1 pgd lgh irg	pgd
bhp hvu ohx ans1 lqx	lqx
ans3 hir tao ykm hcx nvc nvc	hir tao ykm
pgd mbi ans1 god ykm ykm	god
hir ykm hlq ans1 pgd hir pgd hcx	pgd
hlq tao lgh nvc ans1 dyz dyq fro	dyz
ans2 irg lhm ohx bhp dyz	irg lhm
lhm irg ykm ans1 dyq wry	dyq
nvc irg opa wda ans3 icy fro kxd hcx rlt	icy fro kxd
icy kxd rlt ans2 irg rlt dyz	irg rlt
pna rlt ans3 ykm opa irg dyq tao	ykm opa irg
fro irg bhp ans1 lgh kxd god	lgh
dyq ans3 ygj rlt rlt rfm dyz	ygj rlt rlt
ygj ans3 kxd fro nms hcx opa	kxd fro nms
nvc nvc hcx wry ans3 dyz fro fro nms kxd wda	dyz fro fro
dyz fro icy hir ans2 lqx lgh	lqx lgh
irg lqx lqx ans3 rfm nvc hvu lgh ohx	rfm nvc hvu
ans2 dyq god dyq icy hlq	dyq god
nms hcx ohx ans2 tpy nms tao fro	tpy nms
ohx tao pna irg ans1 mbi dyq nms hlq wda	mbi
lgh ykm mbi pgd ans1 rlt	rlt
hcx wry pgd irg ans3 wry pna icy pna tao	wry pna icy
irg hcx bhp hlq ans1 bhp opa lqx	bhp
nms bhp fro kxd ans2 hvu dyz dyq	hvu dyz
dyq pgd kxd ans3 tpy irg hvu	tpy irg hvu
rlt ans3 dyz icy tao	dyz icy tao
tpy bhp opa ykm ans3 kxd tao opa nvc	kxd tao opa
tpy rfm ans1 ohx kxd ohx icy	ohx
ans1 opa god irg wda icy	opa
rfm tpy dyq ans3 ykm dyq tao hlq lqx pgd tpy	ykm dyq tao
hcx lhm dyz ans3 dyq mbi wda hir hcx god	dyq mbi wda
ans1 lqx	lqx
pna ykm lgh hcx ans2 bhp wry wda lgh hvu ohx	bhp wry
pgd ans1 ykm tpy dyq pna	ykm
wda hvu ans3 ygj hlq hlq rfm pna lqx	ygj hlq hlq
opa god ygj fro ans1 bhp hvu	bhp
nvc ans2 hlq hir tao	hlq hir
ygj ohx ygj ans2 lhm dyz	lhm dyz
lqx rlt ans1 dyz tao	dyz
rfm ans2 opa ykm hcx	opa ykm
hcx ohx ans1 ykm nms hcx dyz	ykm
bhp hcx ans3 rlt wry fro rlt wry bhp	rlt wry fro
wda hir wry ans2 nms hvu rlt hir	nms hvu
pgd lgh ans1 opa mbi	opa
hir kxd ygj kxd ans1 bhp lhm lqx mbi nvc	bhp
irg ans3 tao nms mbi nms god	tao nms mbi
kxd ans3 pna wda ohx	pna wda ohx
pgd wry ans2 lhm bhp	lhm bhp
ans3 hcx ohx rlt	hcx ohx rlt
ans2 dyz hlq ohx tao hir nvc	dyz hlq
ans2 bhp tpy rfm hvu pgd	bhp tpy
ans2 tao wry	tao wry
hcx ygj ans2 wda god nms	wda god
lgh fro ans2 ygj dyz tpy dyz mbi opa	ygj dyz
hvu hcx ans3 lhm tao nms	lhm tao nms
bhp fro ohx tao ans3 lhm lhm wry hcx bhp	lhm lhm wry
ans2 hir pna mbi pna wda wda	hir pna
wda lgh pna ans3 wda hvu hcx opa	wda hvu hcx
bhp kxd ans3 ykm lqx rlt pna dyq	ykm lqx rlt
ykm lgh ohx ans2 bhp tao rfm	bhp tao
rfm ans1 hir	hir
lhm god nms ygj ans1 hcx ohx hlq hlq	hcx
ans3 fro irg kxd hcx	fro irg kxd
lgh ans1 dyz pna wda pna dyq	dyz
ykm lqx ohx hlq ans2 irg lgh	irg lgh
mbi ykm pna ygj ans2 opa pgd tao hlq rfm ygj	opa pgd
ans2 lhm kxd dyz tpy	lhm kxd
bhp pna god ans3 pna wry fro hcx	pna wry fro
ans1 dyz	dyz
pgd bhp ans3 ykm tao pna fro mbi	ykm tao pna
ohx pgd rfm ans3 wry hcx pgd tpy hvu	wry hcx pgd
irg mbi opa god ans1 wry god	wry
kxd ans3 mbi pgd nms god hcx	mbi pgd nms
nms nvc ans3 kxd ygj nms wry	kxd ygj nms
wda pna ans2 ohx irg tao ygj hir lqx	ohx irg
tpy rfm lqx ans3 opa lqx fro pgd	opa lqx fro
dyq ans1 nvc icy kxd lhm	nvc
ohx kxd ans2 kxd irg kxd bhp	kxd irg
tao opa nms irg ans1 rlt fro kxd pna	rlt
hvu hir nms ans3 nms hcx kxd fro wry	nms hcx kxd
dyq ans3 tao bhp tao dyz bhp	tao bhp tao
hcx ans1 nms god rlt	nms
pna irg ans1 icy dyz icy irg	icy
ohx hir ohx ans1 tpy	tpy
ans2 bhp mbi	bhp mbi
ans1 pgd	pgd
ans3 ykm wry tao lqx pna icy	ykm wry tao
hlq ans3 kxd lgh ygj fro nms tao	kxd lgh ygj
hir mbi hvu ans1 lqx bhp	lqx
ans1 hir	hir
dyz hvu ans3 bhp god tpy opa nvc bhp	bhp god tpy
ans2 rlt hvu opa	rlt hvu
ans1 wry	wry
ans2 ohx hir wda ykm nms hvu	ohx hir
fro opa ans1 bhp bhp tpy	bhp
icy ykm nvc ans2 pna rfm opa wry ygj rlt	pna rfm
fro kxd nms tao ans3 hvu pgd nvc god hvu pna nms	hvu pgd nvc
icy hir ans1 lhm ykm lgh	lhm
dyz nvc lhm ans1 nvc	nvc
ans3 kxd hlq mbi	kxd hlq mbi
irg ans3 tpy nvc pgd hlq dyq dyq	tpy nvc pgd
dyq ans2 tpy rlt rlt	tpy rlt
lgh irg ygj ans1 ygj dyz hlq nms	ygj
wda ans1 hcx ohx lqx opa	hcx
nms fro ans2 pna dyq bhp	pna dyq
hlq bhp pna lgh ans3 irg hir rfm rlt pgd pna opa	irg hir rfm
kxd lhm ans3 nms ohx nvc	nms ohx nvc
bhp hir ykm ans3 lqx god opa fro dyz pna	lqx god opa
ans1 nvc nms	nvc
ans3 opa hcx nms lqx nvc	opa hcx nms
kxd ans3 rlt rlt nms hcx tao	rlt rlt nms
dyq pgd dyz lqx ans2 nvc tpy	nvc tpy
opa rlt ans1 wry dyz bhp mbi hcx	wry
rlt rfm ans3 wry ohx tao rlt mbi fro lhm	wry ohx tao
ans3 opa tao wda ohx tpy irg	opa tao wda
opa ygj ans2 dyq kxd mbi	dyq kxd
mbi ans3 tao pgd hvu	tao pgd hvu
hlq ohx mbi wda ans1 rlt tpy	rlt
wry lqx ans2 hir tpy	hir tpy
icy bhp ans3 nms ykm bhp tpy	nms ykm bhp
dyz ans1 hlq lhm dyz icy	hlq
dyq lqx dyz hvu ans3 wry bhp hlq ohx rfm ykm ykm	wry bhp hlq
rlt ygj irg opa ans3 nms hvu wry tao	nms hvu wry
wry pna ans1 ykm icy wda hvu ohx	ykm
nms ans2 kxd rfm pgd wda mbi dyz	kxd rfm
dyz opa god nms ans1 nms wry lqx ohx fro	nms
dyq irg ans2 dyq rfm opa	dyq rfm
ans2 nvc mbi mbi lqx bhp	nvc mbi
tpy god ans2 pgd kxd wry nvc	pgd kxd
ans2 ykm pna	ykm pna
hvu dyq lhm ans2 wry fro dyz	wry fro
ans1 pna ohx	pna
dyz ans1 god hlq ygj	god
ans2 wda pgd lhm	wda pgd
hlq opa kxd ans3 lgh nms hlq lhm wda	lgh nms hlq
ans1 lgh icy	lgh
hlq hlq hvu icy ans2 lqx fro dyz	lqx fro
tpy kxd hcx nms ans3 ygj hlq ohx ykm hir wry	ygj hlq ohx
nms pna lhm ans1 icy tpy rfm	icy
ans1 lqx mbi	lqx
irg ans3 rfm god hvu bhp rlt wry ohx	rfm god hvu
kxd lqx ans1 dyq rfm nvc kxd hcx	dyq
kxd dyz bhp ans3 hcx nms hvu dyq tpy	hcx nms hvu
icy hlq ans1 lgh bhp nvc icy wda	lgh
kxd ohx rfm ans3 nms nms ygj	nms nms ygj
god pna ans2 pgd lgh dyq tao	pgd lgh
opa opa ohx ygj ans1 lgh wry rfm	lgh
lgh wda lgh nvc ans1 wry	wry
ans1 tao rfm	tao
ans1 hlq lqx icy ohx fro	hlq
nvc hcx ans3 rfm fro nms opa	rfm fro nms
kxd ygj ans2 tpy god	tpy god
hcx mbi dyz opa ans2 lhm ygj	lhm ygj
icy ans3 lgh hvu bhp ygj wda pna tao	lgh hvu bhp
opa opa lhm ykm ans1 fro	fro
bhp bhp ohx opa ans1 wry lhm lhm	wry
fro tao ans3 wry hlq mbi rlt	wry hlq mbi
mbi hir nms ans3 dyz hvu hvu	dyz hvu hvu
nvc pna wda ans1 hlq pna fro pgd rfm	hlq
irg ans3 tpy ohx wry pgd fro ohx	tpy ohx wry
irg ans2 bhp lhm mbi	bhp lhm
mbi god ans2 hvu pna hcx	hvu pna
dyz ans2 mbi bhp pgd pna	mbi bhp
lhm lqx opa tpy ans3 mbi opa mbi wry icy fro nvc	mbi opa mbi
ans1 hlq icy dyq rlt	hlq
ans2 irg lhm irg nms	irg lhm
ans1 dyq	dyq
ans1 hcx kxd ohx tao	hcx
ans2 rlt opa irg lqx wda	rlt opa
ans3 pna opa tao	pna opa tao
nms ans1 pna	pna
mbi dyz god rlt ans1 wda hvu lqx dyq	wda
ans2 dyq nvc rfm hir	dyq nvc
tao god hir ans3 hcx hlq bhp tpy dyq lgh rlt	hcx hlq bhp
ans2 opa lhm wry lgh pgd	opa lhm
pgd ygj mbi kxd ans1 rfm god pgd lhm ykm	rfm
dyz pna ans3 hcx ykm ykm god ohx lhm god	hcx ykm ykm
tao lhm hvu ans1 lhm ohx dyq hir hir	lhm
ykm ans1 icy dyq god	icy
ans1 tpy	tpy
wda ans2 nms mbi	nms mbi
mbi pna hir tao ans1 tao rfm	tao
lqx pna dyq ans2 nvc lqx wda hvu god rfm	nvc lqx
icy ans2 ohx hlq rlt	ohx hlq
lgh mbi ygj pna ans2 nms lhm ykm wry	nms lhm
icy ohx fro ans2 mbi lgh fro god	mbi lgh
hcx rfm ans2 opa tao nms god	opa tao
ans1 icy	icy
ans2 tao nvc opa dyq rfm	tao nvc
pgd lgh wry ans1 lqx rfm tao dyq	lqx
ans1 hcx dyq icy	hcx
god ans3 dyz rlt nms rfm bhp hcx	dyz rlt nms
ans2 opa wry god	opa wry
opa rlt ans1 dyq	dyq
dyq ans3 hvu rfm pna tpy	hvu rfm pna
ohx hlq pgd ans3 dyz tpy hlq wda	dyz tpy hlq
ans3 icy bhp ohx tao wda	icy bhp ohx
ykm ygj ans3 rfm hir god bhp icy	rfm hir god
god wda ans3 wry nms hir wry ykm mbi	wry nms hir
wda nvc fro ans2 dyq ohx icy	dyq ohx
irg tpy tpy ans2 hcx rlt lgh lhm nvc pgd	hcx rlt
ans1 icy bhp lhm rlt	icy
hvu hir lhm wda ans1 ohx god lhm hir god	ohx
ygj irg lqx pna ans2 pna ykm fro dyq	pna ykm
god ans2 ohx ohx irg hvu dyq lgh	ohx ohx
ykm wry fro ans2 god hlq dyz hlq bhp rfm	god hlq
ans1 rfm tpy	rfm
ygj ans2 lqx hcx hlq pgd ygj	lqx hcx
ans1 god	god
lhm ans1 rlt mbi fro	rlt
dyz tao lhm ans1 kxd	kxd
bhp lhm ans2 kxd dyz rfm dyq	kxd dyz
wda lqx lhm wda ans2 tao pna	tao pna
fro ans1 icy	icy
ygj ans2 hvu icy	hvu icy
hlq hir opa ans1 icy rfm lhm mbi	icy
hcx opa bhp ans2 ohx lhm nms pna kxd	ohx lhm
god lgh fro ans2 ykm opa irg	ykm opa
ans2 pgd mbi wda kxd nms dyq	pgd mbi
hir lqx ans1 mbi hcx fro	mbi
tpy nms ans1 ykm dyq lqx nvc	ykm
kxd ykm ans1 hvu	hvu
dyz mbi ans2 lqx wry wda lqx	lqx wry
irg hvu ohx ans1 hcx hvu hir opa	hcx
wda hcx ans1 ohx dyq	ohx
ans1 irg pna	irg
opa ans3 pna rlt mbi lqx	pna rlt mbi
ans3 hcx rfm pgd	hcx rfm pgd
tpy tpy wda rlt ans2 hir irg pgd wda icy hir	hir irg
wry pna hlq rlt ans1 ykm mbi	ykm
lqx ans1 wda tao ygj lgh dyz	wda
opa ykm ohx ans1 tpy	tpy
kxd ans1 dyz dyz nvc hcx	dyz
rfm ans3 dyz icy god irg hvu wda wry	dyz icy god
icy ans1 mbi rlt ygj hcx dyq	mbi
pgd hcx ygj ans1 nms kxd	nms
ans1 dyq dyq tao pna	dyq
ygj hvu ans1 dyq ykm	dyq
god bhp ans1 dyz ohx	dyz
ans1 dyq opa hlq mbi wda	dyq
tpy ygj lhm ans3 ygj ohx hcx fro lgh rlt	ygj ohx hcx
tao icy ans3 nms pgd hlq dyz wda	nms pgd hlq
lhm lqx dyz ans1 dyq irg ygj pna hvu	dyq
kxd god hvu ans2 bhp rfm nvc irg	bhp rfm
ans2 dyq nvc god mbi ohx lqx	dyq nvc
wry wda ans2 wda dyz fro	wda dyz
ans1 dyq ohx hvu	dyq
irg kxd hcx ans2 hir ohx pna mbi lqx bhp	hir ohx
ohx bhp mbi dyz ans3 wry wda pna opa	wry wda pna
rlt ans1 hcx rlt lgh	hcx
ans2 irg hlq ohx	irg hlq
nms ans2 kxd fro lgh	kxd fro
pna ans3 pgd wda hir hvu dyz	pgd wda hir
god kxd lhm ykm ans1 ykm	ykm
ans3 kxd kxd rfm mbi hlq	kxd kxd rfm
ohx hlq icy ans3 lgh mbi lqx mbi nvc lqx	lgh mbi lqx
nms nms lhm ans2 mbi ykm	mbi ykm
mbi rfm ans2 ohx hir kxd hcx pgd	ohx hir
ohx god ans1 wda opa lqx icy pgd	wda
hlq hcx nvc ans1 fro ohx ohx	fro
ans3 nms lgh hvu	nms lgh hvu
ohx ygj ans3 dyq god pgd rlt bhp wda	dyq god pgd
opa dyz hcx irg ans2 opa god	opa god
lqx ohx wry lhm ans3 mbi nms hir	mbi nms hir
dyq god ans2 mbi rlt rfm kxd opa	mbi rlt
hcx ans3 dyq ygj lhm tpy bhp	dyq ygj lhm
hcx irg ans1 bhp pna	bhp
ans3 rlt ohx icy ygj hcx mbi hir	rlt ohx icy
wda hvu tpy mbi ans1 pgd	pgd
tao icy ans2 opa ohx	opa ohx
hlq ans2 mbi nms hcx	mbi nms
lhm nvc lhm ans1 lgh	lgh
icy irg tpy dyq ans3 mbi tao icy pgd nms pna	mbi tao icy
nms dyz ans3 hcx wda tao ykm rlt	hcx wda tao
lhm ans3 god nvc lhm mbi pgd hir irg	god nvc lhm
kxd opa ans3 rfm nms mbi wda rfm tao	rfm nms mbi
kxd nms ans2 wda mbi rlt irg lgh rfm	wda mbi
tao ans1 lhm wry	lhm
tpy irg hlq lqx ans3 nms pna rlt hir mbi lgh wry	nms pna rlt
pna ohx ans3 opa nvc rfm lqx	opa nvc rfm
nvc lgh lqx ans3 hvu opa rfm ohx	hvu opa rfm
hvu wry kxd hcx ans1 hvu	hvu
rfm nvc dyz ans3 tpy wda ykm hir rlt tpy	tpy wda ykm
fro dyz ans3 hlq hir ygj wda lgh ygj	hlq hir ygj
fro ans2 nms lgh lgh fro opa	nms lgh
lhm kxd tao pgd ans1 lgh mbi opa hir	lgh
hlq lqx hvu nms ans2 wda hir rfm	wda hir
ans3 pna dyq opa kxd	pna dyq opa
pna ans2 hcx hir dyz lqx ohx	hcx hir
ohx ohx ans3 rfm ykm opa	rfm ykm opa
hcx wda ygj ans2 hir mbi opa bhp rlt	hir mbi
hlq lgh ans2 irg fro rlt ykm kxd dyz	irg fro
tpy pgd ans2 hcx tao tpy rlt	hcx tao
lqx ans1 rfm	rfm
rlt ans3 lqx hir wda rfm tpy god	lqx hir wda
irg ygj ans3 god hvu fro hvu	god hvu fro
dyq icy hlq ans2 dyq tao dyq opa dyq nms	dyq tao
lhm hlq dyz rfm ans2 hir pgd fro lgh ohx pna	hir pgd
ans2 irg rfm ohx hlq	irg rfm
wry rlt ans2 kxd rfm wry tao icy	kxd rfm
fro dyz ans1 dyz dyz irg	dyz
nvc dyz irg ans2 hir bhp opa lgh icy god	hir bhp
wda dyz irg ans3 nms hir wry fro fro fro rlt	nms hir wry
tao lhm ans3 tao lqx pgd kxd	tao lqx pgd
pna ans3 hlq opa lhm	hlq opa lhm
nvc wry ans1 icy mbi	icy
kxd lgh dyq ohx ans3 fro lhm hvu nvc lgh lhm pna	fro lhm hvu
ans2 wda kxd nvc bhp	wda kxd
hcx lqx dyz wry ans2 dyz rfm dyz pgd	dyz rfm
nms nms ans2 wry rfm bhp opa kxd pgd	wry rfm
lhm tpy fro ans1 tao rfm	tao
hir ans3 nvc hvu irg tao kxd lgh lgh	nvc hvu irg
ygj bhp ans2 fro hvu lgh dyq	fro hvu
bhp hcx tao ans2 ohx lgh god hvu ygj wda	ohx lgh
ygj tpy ans3 rfm ohx lhm rfm ohx lqx rfm	rfm ohx lhm
ohx ans1 hcx lhm pgd ohx lhm	hcx
irg lgh ans1 opa god	opa
tao tao bhp ykm ans3 rlt opa dyq	rlt opa dyq
ans1 rfm	rfm
tpy ans2 hir ygj tao tpy ygj lgh	hir ygj
kxd ans3 tao hcx hvu opa	tao hcx hvu
ans1 hlq nms	hlq
hir wda lgh ans2 pna irg pna opa	pna irg
wda nvc wda dyz ans1 dyz rlt rlt icy dyq	dyz
icy pgd dyq ans1 lhm	lhm
kxd hlq ygj ans1 icy	icy
ohx ykm ans2 kxd tao dyz	kxd tao
lgh icy rlt ans3 rfm bhp pna ykm lqx	rfm bhp pna
fro ans2 nvc lgh rlt lgh tpy	nvc lgh
ygj ans2 wda pgd hir	wda pgd
mbi hir tao hvu ans1 wry hcx ykm	wry
ans3 pgd opa wda mbi	pgd opa wda
icy hlq tpy tao ans1 pgd lgh pgd	pgd
pgd fro ans1 bhp ygj rlt ohx	bhp
fro kxd lqx ans2 pgd tao	pgd tao
ohx wda hlq ans2 nms hcx	nms hcx
lhm ans2 icy ygj wda hir ohx	icy ygj
mbi hvu mbi hir ans2 opa wda tpy rlt	opa wda
ans2 icy ykm nms	icy ykm
wda lhm mbi icy ans2 lgh bhp ohx	lgh bhp
fro wda hir bhp ans3 pna hvu tpy pgd hcx	pna hvu tpy
wry lhm wry fro ans1 bhp ykm ohx fro	bhp
ans2 pgd dyz lhm nvc hlq lqx	pgd dyz
lgh opa ans3 tpy tpy pgd wry dyz lhm	tpy tpy pgd
mbi hvu opa ans2 ygj lgh lgh rfm	ygj lgh
ans1 fro	fro
mbi irg ans1 lhm pna	lhm
ans3 icy irg opa hcx	icy irg opa
ans2 lhm lhm tao nms mbi	lhm lhm
rfm tao lqx ans2 opa icy wry opa	opa icy
lhm bhp lgh ans3 bhp lhm lhm ohx ygj ygj	bhp lhm lhm
kxd ans3 lhm lgh wda	lhm lgh wda
ans1 tpy hlq pgd dyq	tpy
opa icy icy rlt ans2 dyq tpy hlq wry pgd	dyq tpy
hir dyz tpy ans2 wda wda lqx bhp ygj god	wda wda
hvu lhm lhm ans3 lqx ohx kxd wry lhm	lqx ohx kxd
ans2 hvu hcx lqx	hvu hcx
ans3 bhp lgh dyq hvu	bhp lgh dyq
pgd pna ygj wda ans2 kxd lhm hlq dyz opa hcx	kxd lhm
opa hcx nms icy ans1 rlt irg hcx	rlt
ans3 hir lgh dyq pna	hir lgh dyq
ans2 opa lqx mbi hcx	opa lqx
hir pgd fro ans2 nms hlq icy irg mbi	nms hlq
lhm lqx ans3 rlt wry opa wry lhm rfm pgd	rlt wry opa
dyz tao ans1 god god	god
mbi ans3 god mbi fro ohx dyq hcx dyz	god mbi fro
ans3 ohx irg tpy	ohx irg tpy
ans2 dyz hlq rlt	dyz hlq
pgd ans3 dyq nms rlt rfm lhm ygj mbi	dyq nms rlt
ans2 fro hvu dyz bhp	fro hvu
ans2 hvu rlt hvu ohx	hvu rlt
ans3 kxd dyq rlt dyz nms hlq rfm	kxd dyq rlt
rlt nms ans3 lhm rlt hvu bhp	lhm rlt hvu
dyq ans2 pgd dyz ohx	pgd dyz
ohx ans1 rlt ohx ygj ohx god	rlt
ans1 wry icy	wry
tao tpy ans2 dyq wry dyq	dyq wry
opa pgd pna lqx ans2 hlq nms ohx	hlq nms
opa ans2 icy pgd opa hlq icy	icy pgd
rlt tpy ans3 opa pna mbi wry rfm irg	opa pna mbi
rfm hir dyq ans2 fro lhm kxd dyq	fro lhm
kxd icy opa ans3 rfm ygj tao god	rfm ygj tao
ans3 ykm nms wda ygj ygj nms	ykm nms wda
ans2 wry fro opa hcx wda	wry fro
mbi ans1 hir opa lqx	hir
lqx nvc god ans3 god god bhp rlt hir wda tao	god god bhp
ohx rfm ans1 irg mbi rfm	irg
ans2 pna rfm rlt icy	pna rfm
pna ans2 ykm wda lhm ohx	ykm wda
ans1 lhm	lhm
ans1 nms mbi opa ygj fro	nms
god hcx fro nms ans2 wda tpy nvc	wda tpy
hcx ans1 hvu god hcx	hvu
hcx dyq tao hlq ans1 wry	wry
opa hir tao ans3 hlq tao nvc opa	hlq tao nvc
ygj nms lgh lhm ans2 ohx hvu hcx	ohx hvu
tao lgh ans3 kxd mbi rfm opa	kxd mbi rfm
dyq ans1 icy	icy
ans3 god pgd god ohx ykm	god pgd god
tao tpy ans3 lgh god nms wry kxd god pna	lgh god nms
nms tpy nms tao ans2 kxd god rlt lqx rlt	kxd god
opa bhp nms opa ans1 icy tpy wda pna icy	icy
fro hvu ans3 wda dyz fro irg	wda dyz fro
kxd nms nvc ans1 fro kxd	fro
ans2 god dyz rfm bhp ykm	god dyz
kxd lgh ans1 dyz nms	dyz
ans3 lgh hcx wda	lgh hcx wda
dyz bhp ans1 tao pgd ohx	tao
rlt ygj hcx ans2 lgh pna hir	lgh pna
ans2 rlt lhm mbi god	rlt lhm
wda ans3 ygj lhm mbi dyq wda nvc	ygj lhm mbi
hir dyq ans1 irg	irg
lhm hcx ans1 mbi icy ykm ygj nvc	mbi
lhm ans3 icy dyq hvu	icy dyq hvu
ygj pgd ans3 tpy tao hir wda rlt	tpy tao hir
rlt ans3 ohx mbi wda icy pgd	ohx mbi wda
tao ohx ans1 god	god
hlq lgh ans2 pgd lgh	pgd lgh
ans2 irg lqx lhm hlq	irg lqx
ygj dyq wry god ans3 hvu lgh opa nvc rlt tpy	hvu lgh opa
opa tao opa god ans2 nvc wry irg god mbi mbi	nvc wry
nms lgh ans3 dyq hlq tao	dyq hlq tao
fro dyq hvu rlt ans1 fro kxd bhp hlq	fro
lhm nms wry ans1 fro pna irg	fro
icy ohx opa god ans3 lhm lqx god	lhm lqx god
dyz icy hvu ans1 dyz	dyz
rfm hcx hir ans2 nms god	nms god
hlq ans2 rlt ykm kxd hir	rlt ykm
ygj rlt dyz opa ans3 rfm mbi hlq hlq mbi dyq	rfm mbi hlq
opa ohx hir ans2 tpy kxd dyz ygj ohx tao	tpy kxd
ans3 tpy rlt fro lqx god	tpy rlt fro
rlt ans1 bhp	bhp
ans2 fro fro dyq kxd	fro fro
lqx god ans2 opa lhm	opa lhm
ans1 lqx hir lgh icy wry	lqx
dyz ans3 rlt irg bhp hcx	rlt irg bhp
hvu dyz ans2 tao god nms ygj mbi rlt	tao god
rlt ygj ans3 pgd ygj ohx	pgd ygj ohx
nvc ans2 hcx tpy lhm lgh	hcx tpy
rfm wry ans1 dyq dyq	dyq
tpy irg ygj icy ans3 rfm dyz dyq bhp dyz tpy lhm	rfm dyz dyq
rfm kxd ans3 hlq opa hlq pgd	hlq opa hlq
wda dyz wry ans1 dyz	dyz
opa ans1 mbi hcx wry rlt wry	mbi
opa dyz hir ans3 tao hir irg	tao hir irg
bhp opa irg bhp ans2 pna lgh ykm hir	pna lgh
ans1 wda ygj tpy	wda
kxd ans1 rfm pna bhp hvu tpy	rfm
tao ohx dyq fro ans2 nms fro dyz nms pgd	nms fro
ans3 ykm hcx hir tao opa rfm ykm	ykm hcx hir
hlq ans3 wry bhp nvc pna hir	wry bhp nvc
tpy hir ans2 pna dyq	pna dyq
fro nms ohx kxd ans3 wda lhm hir	wda lhm hir
mbi ans3 wry hvu tpy ygj	wry hvu tpy
ans1 icy dyz ohx nms	icy
wry pgd lqx kxd ans3 god rlt dyq god hir	god rlt dyq
ygj god opa ans1 irg tpy	irg
fro lqx ans2 bhp god wry nms	bhp god
hir nvc god wry ans2 hlq ygj	hlq ygj
lqx ans2 nms lqx nms lqx	nms lqx
rfm dyq lgh ans1 fro lgh	fro
mbi lgh nvc ans3 dyz tpy ykm	dyz tpy ykm
hlq bhp nvc ans3 irg dyz irg icy lqx irg	irg dyz irg
ans1 rlt irg hcx	rlt
ygj irg kxd lgh ans2 irg lhm lgh ykm rlt	irg lhm
ans2 tpy dyz fro dyq hlq nvc	tpy dyz
bhp ans3 pgd nvc hcx	pgd nvc hcx
lhm ans3 ohx lhm kxd	ohx lhm kxd
lhm ans1 mbi ygj kxd	mbi
dyz rlt nvc bhp ans1 dyq fro rfm mbi tpy	dyq
tao pgd lhm ans3 pna nvc icy dyz ykm	pna nvc icy
dyz nms wda lqx ans1 wry	wry
lgh dyq ans1 hir rfm	hir
god ans2 rfm bhp ohx dyz ykm hcx	rfm bhp
hir god dyq hvu ans2 wry dyq	wry dyq
lqx bhp lqx bhp ans2 pna lgh kxd lgh mbi irg	pna lgh
ans3 pna ykm ygj hir dyq hir lhm	pna ykm ygj
opa lqx ykm dyq ans3 lhm ygj hcx nvc hir	lhm ygj hcx
kxd ykm dyq ans1 opa hlq	opa
ans2 hvu rfm	hvu rfm
ykm ans2 pna ykm	pna ykm
lhm nms fro dyq ans2 dyq hvu ykm dyz ykm	dyq hvu
fro ans1 lhm irg icy mbi	lhm
pna ans2 nvc tao wry lqx pna dyq	nvc tao
hvu bhp ans1 opa wry	opa
ans2 lqx lgh lgh hir lhm	lqx lgh
ykm icy ans3 irg god dyz lgh fro	irg god dyz
ans2 ohx icy pna	ohx icy
hir wry lhm lgh ans1 hcx	hcx
lgh ans1 lgh pgd wry	lgh
pgd nvc ans1 nms bhp irg tao ykm	nms
ans3 lqx ykm pgd	lqx ykm pgd
lgh ohx ans3 tao ykm lhm	tao ykm lhm
fro wda nvc ans2 nms nvc god god lhm	nms nvc
hcx ans2 nms tao dyq ykm bhp rfm	nms tao
bhp tpy ygj god ans2 rfm kxd	rfm kxd
pna ans1 icy pgd hcx	icy
nvc lqx fro lqx ans1 dyq	dyq
nvc ans3 lhm hvu mbi lqx rfm	lhm hvu mbi
lgh hcx mbi ans2 kxd wda ohx	kxd wda
mbi hir hcx rlt ans3 hcx nvc hlq hvu opa	hcx nvc hlq
lqx irg god ans1 lhm	lhm
hvu ans1 lhm	lhm
dyq bhp ans2 rlt nms tpy icy	rlt nms
god ans2 tao god ykm god ygj	tao god
nms ans3 ykm kxd tpy hlq tao	ykm kxd tpy
nvc lhm ans1 lgh	lgh
tao ohx hlq ans1 ygj pgd	ygj
lhm icy dyz ans2 lhm tpy tao hlq lqx ygj	lhm tpy
hcx pna ans1 icy	icy
rlt tpy mbi bhp ans3 pna mbi ykm	pna mbi ykm
kxd bhp ykm pgd ans1 pna pgd dyq lgh	pna
bhp lqx ans1 dyq hir dyq	dyq
ans2 kxd ohx rfm	kxd ohx
ohx ans2 bhp icy	bhp icy
rlt lhm pgd ans1 rfm rfm dyz opa	rfm
opa hir ans3 rfm hvu tao fro lhm nms	rfm hvu tao
dyz ans3 lgh ykm icy ykm icy hvu	lgh ykm icy
dyz ans3 rlt rfm nms tpy lqx kxd hcx	rlt rfm nms
rfm pgd hir pgd ans3 wry wry pgd ykm pna pna pna	wry wry pgd
tao hcx dyz tao ans1 dyq	dyq
ans1 hcx dyz dyz	hcx
lhm ans3 rfm ohx mbi lgh	rfm ohx mbi
ans2 hcx kxd opa lhm bhp tpy	hcx kxd
dyz ohx god pgd ans1 dyz lgh pna	dyz
nms nms hcx lqx ans1 icy icy god	icy
ykm ans3 lgh hcx wda rlt lhm tpy nms	lgh hcx wda
tao tao hcx nms ans1 rlt opa kxd mbi rlt	rlt
lhm pgd dyq ans1 hlq ohx kxd tpy pna	hlq
ans1 mbi tao wry	mbi
ohx opa mbi ans1 irg pna rfm nvc	irg
tpy ans2 tpy bhp	tpy bhp
lhm nvc dyq lhm ans2 bhp wry irg hlq	bhp wry
wry nms ans3 tpy ohx rlt fro	tpy ohx rlt
icy ans2 fro dyz lgh	fro dyz
kxd wda bhp dyz ans2 wda mbi nvc	wda mbi
hcx ykm ans1 hvu hcx fro	hvu
mbi pna ans2 lhm lgh wry	lhm lgh
icy icy rlt ans2 tpy rlt ykm	tpy rlt
opa mbi hvu wda ans2 hir kxd dyz wda hir	hir kxd
hir ans1 irg kxd tpy god	irg
ohx wry ans2 fro ykm hir ohx pgd	fro ykm
pna ans2 pna god rfm mbi	pna god
lgh dyq ygj ans1 nms lgh wda nvc lgh	nms
wry rlt ykm god ans1 hlq lqx rfm	hlq
tpy icy irg god ans1 ygj tpy	ygj
ykm ykm kxd ans1 nvc nms	nvc
mbi ans1 hlq	hlq
ans1 lgh bhp	lgh
kxd ans1 hcx icy pgd	hcx
dyz ans3 dyq ykm hvu kxd nms	dyq ykm hvu
pgd dyz icy ohx ans2 tao lgh ykm lqx	tao lgh
nvc god hcx ans1 dyz rlt rlt rlt	dyz
hir pna lqx lqx ans3 ohx wda hcx nvc ohx	ohx wda hcx
hlq ans1 nms rlt fro	nms
rfm nvc bhp ohx ans3 lhm pgd tpy	lhm pgd tpy
wda nvc irg ykm ans2 hvu lgh	hvu lgh
ans1 ygj ygj	ygj
tao fro lgh bhp ans2 ykm fro icy god nms	ykm fro
hir ans1 mbi bhp	mbi
dyq ans2 ykm nms ohx icy	ykm nms
icy rlt kxd ans1 ykm	ykm
ans1 pna	pna
lhm kxd fro kxd ans1 irg nms wda	irg
kxd hlq ohx ans1 icy	icy
nvc fro ans2 rfm lqx dyz hvu kxd nms	rfm lqx
hlq god ykm ans2 hcx mbi hvu	hcx mbi
ykm nms ans1 wry ygj	wry
dyz fro nms mbi ans1 lgh	lgh
god irg ans2 lgh wda lqx	lgh wda
god lgh ohx ans2 tpy lhm	tpy lhm
mbi ohx ans3 irg hir hir fro dyq dyz icy	irg hir hir
lgh lhm tpy rlt ans2 nvc ohx irg god fro	nvc ohx
ans3 pgd god god dyz lgh lgh	pgd god god
fro icy god hir ans1 dyz hvu dyq wry hvu	dyz
lhm bhp bhp ygj ans3 lqx tpy hcx kxd god	lqx tpy hcx
ans1 lhm	lhm
ans3 pgd rlt hir nvc lqx bhp hir	pgd rlt hir
ans3 nms mbi mbi wda lqx	nms mbi mbi
ans1 nms pgd irg ykm	nms
ans3 wry fro ykm kxd dyq rlt god	wry fro ykm
fro ans1 bhp lqx	bhp
pna ans2 kxd bhp hir	kxd bhp
ans3 wda nms bhp rlt	wda nms bhp
ans1 hlq wry	hlq
lhm ans1 opa ohx kxd hir	opa
pgd tao tao ans1 ykm tao wry bhp	ykm
opa rlt ohx lqx ans3 mbi wry rlt lhm dyz	mbi wry rlt
rfm bhp lhm bhp ans3 ohx kxd nvc	ohx kxd nvc
dyz nms hlq ans1 nms pna rlt wda	nms
rfm ans2 pna tao wda	pna tao
hvu pna hvu ykm ans1 bhp	bhp
ykm dyq ans1 kxd	kxd
ans1 lqx wry tpy wry fro	lqx
ohx ans3 kxd opa lqx pna	kxd opa lqx
irg fro ans3 ygj kxd irg wry	ygj kxd irg
tao ans3 mbi hcx pgd	mbi hcx pgd
fro ykm hcx rfm ans3 lgh opa hvu pgd	lgh opa hvu
dyz rlt ans2 pgd rlt lqx lqx	pgd rlt
ans2 wda tpy icy pna irg fro	wda tpy
lgh tpy ans1 fro irg ygj hvu nms	fro
dyq ans1 hcx	hcx
opa ans1 wry	wry
hvu nvc dyq rfm ans2 ykm nms wry irg hir icy	ykm nms
hlq lgh ans2 lhm pgd opa nms tpy ohx	lhm pgd
hir mbi ans1 lhm dyz bhp nvc ygj	lhm
dyz ans2 hcx wda ykm wda	hcx wda
fro wda ans3 ygj nvc fro tpy	ygj nvc fro
ans1 dyq opa	dyq
lhm hcx ans1 icy pna	icy
ans1 hlq irg lgh bhp	hlq
nvc hvu ans1 hlq ohx ykm	hlq
hlq wda ans1 bhp	bhp
dyq tpy lhm rlt ans3 irg wry pgd wry tao	irg wry pgd
ans3 hlq lhm rfm ygj rlt god	hlq lhm rfm
kxd god opa irg ans1 rlt	rlt
ans1 lqx	lqx
ans2 hir rlt hlq fro	hir rlt
mbi ans2 pna nvc rfm rlt lhm hvu	pna nvc
ohx lhm hir ans1 hir	hir
ans3 fro bhp hir dyq irg wry hcx	fro bhp hir
ans1 wda lhm	wda
ans1 dyq lgh wda tpy hir	dyq
ohx ans1 hir pna	hir
bhp lhm ykm opa ans3 pna hlq hir rfm	pna hlq hir
hcx lhm opa kxd ans1 nvc hir hvu ohx god	nvc
nvc tpy ans3 kxd tao pna fro ohx tao	kxd tao pna
hir hcx ans1 tpy tpy ohx kxd mbi	tpy
tpy hcx irg god ans2 wry bhp ykm wda	wry bhp
ans1 pgd lgh nvc	pgd
ans2 wry lhm icy rlt	wry lhm
wda icy god ans1 god hlq fro wry	god
opa ans3 ykm god tao tao hcx dyz icy	ykm god tao
rlt lhm rlt ans1 god ykm	god
kxd rlt ans2 hvu kxd lqx hvu	hvu kxd
lgh ans2 nvc fro lhm	nvc fro
mbi hlq hlq ans1 wry hlq	wry
hir irg lgh kxd ans2 irg ygj ykm	irg ygj
nms ans3 bhp lhm irg hlq god ykm	bhp lhm irg
bhp dyq ans2 opa hvu hlq mbi hcx hlq	opa hvu
hcx ans1 mbi irg opa hcx	mbi
nvc dyz icy rfm ans3 opa hcx lhm irg	opa hcx lhm
mbi pna ans3 rlt tao tpy nms rlt tpy	rlt tao tpy
tpy ans1 bhp wda bhp lqx god	bhp
bhp ohx ans1 nms	nms
tpy ans1 ohx nms	ohx
rfm pna rfm nms ans3 hcx pgd wry	hcx pgd wry
hir ygj wry mbi ans3 wry opa dyz hir rfm	wry opa dyz
ans1 opa lhm pna bhp	opa
ans2 opa lhm	opa lhm
rlt nms ans2 ohx wda nms	ohx wda
dyq opa wda tao ans1 ykm bhp	ykm
hlq lqx ans1 kxd tpy icy rlt mbi	kxd
nms icy ans1 mbi dyq hcx pgd	mbi
nvc ans2 nvc hvu	nvc hvu
tpy icy hir opa ans2 mbi rfm nvc	mbi rfm
hir irg bhp ans2 dyq lhm dyz irg wry	dyq lhm
lqx pgd ykm ans1 rlt mbi pna	rlt
hvu opa ans2 dyz nms lqx nvc ohx wda	dyz nms
icy ans1 ygj	ygj
lgh god tpy ans1 god fro dyz	god
hvu nms ans3 pna dyq nvc tpy hir lqx	pna dyq nvc
ans2 pgd opa god wry	pgd opa
ans3 wry pgd irg ykm lhm	wry pgd irg
god bhp hlq rlt ans2 tao wda hcx wda	tao wda
ans2 dyz hvu tao lhm dyz	dyz hvu
ans2 pgd nvc	pgd nvc
lgh dyq pgd ans3 hcx fro kxd mbi nvc	hcx fro kxd
tpy ans1 hcx lqx	hcx
rlt rfm irg ans1 bhp ygj opa	bhp
ans2 dyq wry pna lhm	dyq wry
hir ohx ans3 ykm wda lgh	ykm wda lgh
ans1 nms dyq opa wry	nms
irg tpy ans1 rlt fro bhp kxd pna	rlt
rlt fro nvc ans2 hlq nms lgh	hlq nms
tao fro dyq dyz ans2 god irg rfm lgh	god irg
ygj lqx tpy ans1 nms fro fro	nms
ygj tpy tao irg ans3 hvu tao bhp dyq god pna irg	hvu tao bhp
tpy ans2 dyz ykm lgh nms	dyz ykm
nms rfm ans2 nvc lqx ohx fro	nvc lqx
nvc hir god tao ans3 bhp icy lqx hlq	bhp icy lqx
hlq nms bhp fro ans3 nvc rfm nms rfm rfm	nvc rfm nms
ygj lqx wry ans3 wry god bhp mbi opa	wry god bhp
hlq ohx dyz fro ans2 wda pgd irg dyz hvu wry	wda pgd
hlq opa nms pna ans2 hir hir kxd icy nvc rfm	hir hir
pgd rlt dyq rfm ans1 opa ygj hvu opa nvc	opa
rlt ans2 mbi wda hcx	mbi wda
mbi dyz ans2 bhp lgh tao tao dyq ygj	bhp lgh
god ans1 pgd	pgd
ans1 fro lhm	fro
ans1 mbi ygj kxd lgh hcx	mbi
pna hir ans2 hvu lgh hvu	hvu lgh
hcx opa ans1 god wry god rlt	god
hcx nms ygj ans2 tao opa	tao opa
dyz tao ans3 irg tao mbi	irg tao mbi
tpy pna dyq wry ans1 hvu ohx rfm	hvu
nms dyq icy dyz ans1 lqx	lqx
ans2 lgh pgd dyz	lgh pgd
hcx ans3 hlq lgh tpy	hlq lgh tpy
hvu nvc opa ans2 hlq opa hlq rlt	hlq opa
ans1 nvc lhm dyz mbi	nvc
hcx hcx wda lhm ans2 lqx tao opa rfm	lqx tao
icy ans1 wda ygj	wda
dyz wry irg ans3 hir tpy nvc bhp rfm	hir tpy nvc
pna ans2 mbi dyz kxd ykm hir hvu	mbi dyz
rlt ans1 ygj	ygj
bhp tpy dyq ans2 dyz hvu fro	dyz hvu
pgd tpy pna ans2 nms icy dyq	nms icy
rfm lqx tao hir ans1 god hir opa	god
tpy lgh kxd rfm ans1 hir wry fro	hir
wda mbi icy ans3 opa pna mbi kxd rfm lhm	opa pna mbi
hir rlt hir ans1 hcx	hcx
lqx ans2 irg god rfm pna kxd rfm	irg god
nvc ans3 hir mbi opa pgd god	hir mbi opa
irg nms hvu ans2 dyq tao	dyq tao
lhm ans3 dyq ygj kxd icy	dyq ygj kxd
tpy lhm ans2 mbi ohx	mbi ohx
ans2 bhp rfm pna pgd	bhp rfm
wry bhp hir pna ans1 dyz mbi	dyz
lgh wda hcx fro ans2 lhm tpy nvc	lhm tpy
lhm rfm lhm ans3 dyz lgh dyz wda kxd	dyz lgh dyz
mbi ans2 hcx nms dyq icy wry	hcx nms
wda icy ans3 lhm ykm lhm hvu icy	lhm ykm lhm
ans2 dyq lhm pgd tpy lgh	dyq lhm
ans3 rlt fro opa icy god	rlt fro opa
dyz wry fro ans1 kxd god fro hlq	kxd
rfm nms lhm lqx ans1 ygj nms fro god	ygj
lgh ans2 fro nvc mbi hir	fro nvc
lgh ans1 lhm pgd tao ohx	lhm
pgd ans2 ohx hlq rlt	ohx hlq
tpy icy ans1 irg icy	irg
rfm lqx tpy ans2 hcx tpy nvc ykm fro hcx	hcx tpy
hir nvc hir ans1 ygj god dyz fro	ygj
pgd pgd lgh icy ans2 wry nms	wry nms
lqx bhp rfm god ans2 ygj rlt	ygj rlt
tao ans1 hlq pna mbi irg mbi	hlq
pgd ygj ans1 bhp hlq ykm lgh lqx	bhp
lgh pgd hir dyq ans2 lhm icy	lhm icy
lqx hlq ygj ans1 hir ygj hlq fro hir	hir
irg tao pgd ans3 pna rlt dyq	pna rlt dyq
hcx hcx nms wda ans2 nvc dyq	nvc dyq
rlt rlt lqx kxd ans2 dyz pna tao hcx	dyz pna
rlt opa ohx ans2 dyq lgh	dyq lgh
pna mbi nms wry ans2 icy god rlt tpy tao nvc	icy god
ans2 mbi ykm nvc lhm rlt	mbi ykm
ans3 fro hlq pna rfm	fro hlq pna
ans3 god hcx hir lqx rlt fro irg	god hcx hir
ans1 fro opa lqx lgh	fro
ans1 mbi opa wry hvu	mbi
lhm irg ans3 ohx ohx tpy lgh lhm	ohx ohx tpy
ans2 kxd hlq hlq wda lqx	kxd hlq
pgd dyz kxd ans2 tpy icy tpy kxd tao	tpy icy
ans2 hlq dyz bhp ykm	hlq dyz
bhp ykm bhp ans1 ygj hir opa god	ygj
dyq irg ans3 hlq dyz lhm icy hir wda	hlq dyz lhm
lqx irg ans3 irg mbi dyz nms	irg mbi dyz
wda pgd nvc lgh ans1 hcx irg rlt wda hir	hcx
ans3 dyq hvu wda ygj nms mbi dyq	dyq hvu wda
ans3 tpy ohx god hvu wry kxd wda	tpy ohx god
tpy tpy dyq ans3 rlt lgh hlq	rlt lgh hlq
ans2 god ykm pgd	god ykm
tpy mbi dyq hcx ans3 pgd ohx ygj wry dyz wry pna	pgd ohx ygj
nvc nvc ans1 pgd hcx opa wry hvu	pgd
ans2 lhm wry hvu irg	lhm wry
rlt ohx ans3 nms irg hcx tao dyz	nms irg hcx
tpy ans3 hvu lgh bhp	hvu lgh bhp
god ans2 rfm nvc ykm	rfm nvc
god ans1 nvc wda dyz kxd hir	nvc
dyq ykm ans3 ohx tao hvu dyz	ohx tao hvu
ans1 god lgh lgh irg lqx	god
ans2 nms lhm ygj	nms lhm
hvu hir ans1 hcx tpy ygj ohx lqx	hcx
hcx rfm ans3 dyz bhp wda	dyz bhp wda
bhp god lgh ans3 rfm god hlq hir wda nvc hlq	rfm god hlq
rlt ykm nms ans2 lgh mbi	lgh mbi
hlq ans1 nms wry dyq kxd	nms
ohx hlq hlq ans2 kxd dyq lgh kxd hvu	kxd dyq
tpy ykm icy ans2 hir hlq	hir hlq
ygj ans1 pna wry icy	pna
rlt lhm ans3 rfm ygj kxd ykm	rfm ygj kxd
hlq bhp pna ans2 ygj ohx	ygj ohx
fro kxd dyq ans1 hlq ygj pgd dyz	hlq
pna pna ans1 pna	pna
pgd nms irg lqx ans2 bhp ohx dyz ygj	bhp ohx
dyz fro ohx ygj ans3 rlt opa lhm god dyz	rlt opa lhm
wry ans1 opa pgd	opa
fro wry ans3 wda dyz pgd rlt tao	wda dyz pgd
ans1 pna lhm dyq wda dyz	pna
dyq lhm nvc hir ans3 irg rfm dyq hcx	irg rfm dyq
dyq ohx ans2 pgd bhp kxd wda	pgd bhp
nvc ans1 ykm	ykm
nvc irg lqx ans1 rlt	rlt
nvc hir ans1 hir lgh nms hvu hlq	hir
opa ans2 rfm lgh	rfm lgh
rlt bhp irg kxd ans3 hvu wda god	hvu wda god
ans2 hir lhm ohx dyz rlt	hir lhm
tao pna ans1 rlt nms wda wda lqx	rlt
nms bhp irg tpy ans3 dyz wda pna dyz ohx	dyz wda pna
irg ans3 irg rfm bhp	irg rfm bhp
ygj nms ygj ygj ans3 rlt hcx lqx irg wry dyq pna	rlt hcx lqx
kxd irg lgh ans2 hcx nms hir hcx wry lgh	hcx nms
fro ygj ans3 ygj lgh god nms lgh nms tao	ygj lgh god
hvu ans1 kxd	kxd
tao lhm dyq ans2 lqx icy mbi	lqx icy
ans3 tpy rfm rfm	tpy rfm rfm
mbi rfm ans3 nms pna ygj rlt god hvu nvc	nms pna ygj
wda ans2 wda lhm pna hcx ohx mbi	wda lhm
nms pna mbi tpy ans3 ohx lgh wda wry kxd dyz	ohx lgh wda
ans1 rlt hir hcx dyz lhm	rlt
rfm irg lqx ans3 lgh bhp kxd lgh kxd	lgh bhp kxd
rlt pna ans1 icy irg	icy
dyz hlq ans3 pna irg hvu icy ykm rlt	pna irg hvu
dyq ans3 lqx dyz hcx ohx ohx	lqx dyz hcx
ans2 lgh god	lgh god
ans3 tao god pgd lgh dyz dyz opa	tao god pgd
pna mbi icy ans3 hcx god lgh bhp lhm ohx	hcx god lgh
hir ohx hir ans1 tpy	tpy
ygj ans2 tpy hvu dyz	tpy hvu
pna wry nms lqx ans2 pgd wda wry	pgd wda
pgd icy icy ans3 hcx mbi lqx dyz irg	hcx mbi lqx
ans2 pgd rfm wda hir	pgd rfm
pna bhp ans3 icy fro nms hir wry tao	icy fro nms
lgh nms hir pgd ans1 nvc ohx irg rlt	nvc
ans1 pgd opa	pgd
lqx ykm nvc hir ans3 hvu hir dyz wda	hvu hir dyz
dyq ygj nms bhp ans3 pna nvc wda dyq rlt	pna nvc wda
pgd hvu nvc ohx ans3 bhp wry god bhp icy dyz irg	bhp wry god
god ans1 ohx kxd rlt	ohx
hir tpy ans2 rfm pna	rfm pna
tao bhp dyq ans2 bhp opa lhm lhm tpy lqx	bhp opa
pna opa ygj ans2 lgh rfm dyz ygj	lgh rfm
hvu hir ans2 tpy hlq kxd nms kxd	tpy hlq
tao ans1 dyz rlt dyq	dyz
nvc ans3 lqx bhp lhm	lqx bhp lhm
hlq lgh wda ans1 ykm lqx tao ygj	ykm
ykm ans3 irg rfm lhm icy hir	irg rfm lhm
bhp opa fro ans3 rlt mbi ykm dyz pna hir	rlt mbi ykm
mbi dyz dyq ans3 wda hvu kxd kxd	wda hvu kxd
tpy ans3 ykm tao rlt god hvu hvu	ykm tao rlt
bhp hvu nms lhm ans1 god pna ohx	god
tpy ans3 lhm rfm hir kxd pna hlq pna	lhm rfm hir
kxd rfm ans2 nvc tpy opa	nvc tpy
god lhm ans1 opa mbi fro lqx lhm	opa
ans2 rlt ohx fro	rlt ohx
ans1 god	god
dyq ans1 hcx hlq rfm	hcx
dyz ans3 god ygj rlt lgh ykm hlq tpy	god ygj rlt
ans2 icy lhm hcx tao mbi nvc	icy lhm
icy lhm ans1 lqx ygj	lqx
hlq irg dyq wda ans1 wry fro mbi hlq	wry
dyz ans3 fro rfm hlq lqx	fro rfm hlq
ans1 pna	pna
ans1 rfm	rfm
ykm ans1 tpy tao	tpy
irg fro nvc ans3 kxd irg dyz ygj nms dyz ykm	kxd irg dyz
ans2 pna hcx ohx kxd	pna hcx
ohx hcx ans3 mbi dyq tao	mbi dyq tao
ans3 ohx lgh hlq hir tao dyz	ohx lgh hlq
ohx ans2 nms fro pgd	nms fro
ans1 bhp ohx hlq mbi god	bhp
hlq ans2 kxd lqx	kxd lqx
nvc hvu ykm ans1 bhp	bhp
irg rfm rfm fro ans3 pgd lhm god wry mbi ykm dyz	pgd lhm god
ygj kxd mbi ans2 opa lgh hcx nms	opa lgh
ans3 hcx rlt ykm	hcx rlt ykm
bhp rfm tao lqx ans3 tpy hcx god god	tpy hcx god
dyq nms ans2 ohx bhp tao wda wda tpy	ohx bhp
fro ans3 tao wda ykm pgd	tao wda ykm
kxd ans1 dyq tao	dyq
ans2 wry ygj opa opa	wry ygj
pgd ans1 irg lgh nms dyq hvu	irg
ykm hlq ans2 fro nms nvc ygj lqx ykm	fro nms
ans1 wry wry	wry
bhp wda ans1 god nms tao hcx tpy	god
tpy wda hcx hvu ans3 fro dyq pna bhp	fro dyq pna
irg pna icy ans3 hvu wda nvc pgd nvc tao icy	hvu wda nvc
lgh rfm ans3 rfm opa hlq bhp hlq god hcx	rfm opa hlq
mbi nvc bhp dyz ans1 nms lhm fro tao tpy	nms
rfm mbi bhp wry ans3 irg kxd dyz nms	irg kxd dyz
rlt tao icy ans3 god ohx rlt hcx ygj hcx	god ohx rlt
tao nvc ohx wda ans3 pna pgd bhp nms hcx lqx	pna pgd bhp
pna ans2 hlq nvc tao	hlq nvc
lhm dyq ans2 kxd ohx	kxd ohx
ykm pna ans3 hlq ohx icy opa	hlq ohx icy
pgd kxd rlt ykm ans2 ohx mbi fro	ohx mbi
hvu ans2 wda ygj mbi	wda ygj
kxd lhm tpy lhm ans3 pgd rlt lgh tpy	pgd rlt lgh
ans1 nvc lhm hlq tao	nvc
hir ans3 irg ygj hlq hir bhp hvu	irg ygj hlq
tao ans2 pna ykm tao	pna ykm
ans1 nms irg	nms
dyz ans2 hcx rfm	hcx rfm
lqx irg ykm icy ans3 kxd bhp hlq	kxd bhp hlq
icy mbi tpy mbi ans2 nms mbi	nms mbi
bhp bhp rlt opa ans3 rlt lqx ykm ohx rlt	rlt lqx ykm
irg opa ans1 pgd god hvu opa	pgd
fro ans1 hlq bhp	hlq
hvu bhp lgh dyq ans1 kxd irg ykm hlq	kxd
bhp lgh ans1 hlq rfm god ykm	hlq
ans1 hlq nms opa	hlq
hir hlq lhm ans2 pna nms	pna nms
opa ans2 ygj fro lhm ykm pgd icy	ygj fro
hcx ans2 dyz wda god	dyz wda
hcx dyz ygj ans3 icy opa pna wry mbi nms	icy opa pna
ans1 tao	tao
opa dyq hir ans2 wry icy	wry icy
ans1 ykm bhp fro dyq mbi	ykm
ans2 rfm hir god bhp tpy rlt	rfm hir
opa tao tpy ans2 god rfm	god rfm
icy pna dyz ans3 ykm kxd dyz hlq fro wry rfm	ykm kxd dyz
ans1 mbi tpy	mbi
ans2 tao ykm ygj pna	tao ykm
wry pna fro ykm ans2 pgd hir dyz god nvc fro	pgd hir
hlq ans3 nvc lqx fro	nvc lqx fro
ans2 pgd fro rlt wry tpy hcx	pgd fro
ohx ans3 lhm opa hlq rfm lqx lhm wry	lhm opa hlq
ans2 icy hlq hlq god hir	icy hlq
wda pna wda ohx ans1 nvc hlq icy irg	nvc
hir ans2 ygj hcx opa pgd tpy hvu	ygj hcx
tpy pna lhm ans1 kxd nvc god wry	kxd
ans2 lhm irg god rfm	lhm irg
wda ans3 hcx hlq lhm hir wda lqx	hcx hlq lhm
lqx hlq mbi ans1 tao	tao
rfm ans1 dyq nvc	dyq
rlt ykm nvc lqx ans1 rfm fro rfm tao lgh	rfm
irg wry bhp ans3 hlq dyq pgd ygj	hlq dyq pgd
ygj ans3 god ykm tpy lgh	god ykm tpy
bhp ans1 tao opa irg hcx	tao
opa ohx hcx ans3 nms hlq rfm	nms hlq rfm
mbi bhp dyz lqx ans1 ykm ohx	ykm
rfm opa icy ans1 tpy god	tpy
hcx lgh ans1 ykm lhm	ykm
pna nvc hir ans1 hcx opa	hcx
ans2 ygj god	ygj god
bhp ans3 hcx hvu opa hlq lgh wda	hcx hvu opa
lgh lgh pgd ans2 pgd nms wry dyz dyq lgh	pgd nms
ans1 pna	pna
wda hir ans3 rfm bhp mbi	rfm bhp mbi
lhm ans2 ygj lhm ygj kxd	ygj lhm
fro lgh ans2 pgd icy rlt	pgd icy
opa hir ans1 rfm kxd pna	rfm
irg wda lgh ans3 dyz ykm nvc wry rlt irg pna	dyz ykm nvc
ykm ykm hir wda ans2 pgd tao dyz	pgd tao
lqx ans2 rfm bhp nvc ykm fro ygj	rfm bhp
ans2 nms mbi opa ykm hir	nms mbi
nms ans1 rfm rlt tpy hlq	rfm
lgh irg fro dyz ans1 dyz lgh lqx bhp nvc	dyz
tao icy kxd pna ans2 ykm wda kxd lgh wry pgd	ykm wda
rlt ohx god ans2 lhm lgh	lhm lgh
lgh ans2 tpy dyq pgd lqx bhp	tpy dyq
lqx lgh hir rlt ans1 lgh tpy tao irg hcx	lgh
ans2 rfm ykm wry icy icy	rfm ykm
icy ans2 opa rlt	opa rlt
wda ans2 icy kxd mbi opa hlq mbi	icy kxd
lqx hir ans2 irg pgd tao ohx rfm rlt	irg pgd
tpy irg ans2 god dyz hcx rfm dyq	god dyz
ans3 fro mbi god	fro mbi god
ans3 dyz god opa opa tao	dyz god opa
hlq god tpy tao ans1 lgh wda	lgh
tao nvc ans2 lhm kxd	lhm kxd
ohx ans2 rfm icy pna hlq icy	rfm icy
irg kxd ans3 ykm kxd dyz lgh wry pna mbi	ykm kxd dyz
ans3 ygj lgh fro tpy pna nms	ygj lgh fro
ans3 lhm hir lhm	lhm hir lhm
wda ans2 ykm ygj	ykm ygj
nms opa pna ans3 mbi nvc irg ohx tpy	mbi nvc irg
wry bhp rlt fro ans2 lhm ykm	lhm ykm
ygj dyq nms irg ans3 wda nms ohx opa god	wda nms ohx
wda hcx ohx ans3 fro pgd lhm	fro pgd lhm
kxd tao wry tpy ans2 bhp dyz	bhp dyz
ans2 hvu dyz irg fro pna	hvu dyz
icy dyz nms ans2 ohx hcx opa wry nvc nvc	ohx hcx
ygj ans1 lqx pgd	lqx
rlt wry bhp tao ans2 lgh dyq ykm ygj nms	lgh dyq
icy lqx ans3 wda lgh lqx	wda lgh lqx
wda wry bhp ans3 icy kxd wry icy irg nms	icy kxd wry
bhp tao hlq ans1 lqx pna lqx tao hvu	lqx
hvu rfm hir ans3 tao rfm lgh nvc	tao rfm lgh
ans2 hcx pna mbi hir nvc	hcx pna
bhp bhp hcx ans2 tpy rfm lqx hir	tpy rfm
hir lhm wda ans3 rlt ygj tao	rlt ygj tao
dyz rlt ans3 bhp hlq hcx	bhp hlq hcx
kxd ans3 irg god tpy nvc ohx opa	irg god tpy
nvc hvu icy hlq ans2 bhp lgh ohx hcx	bhp lgh
fro pgd pgd ans2 nms pgd bhp bhp	nms pgd
dyz tao tpy dyq ans3 dyz kxd pgd fro	dyz kxd pgd
hvu irg ohx opa ans3 fro dyz pgd ygj lqx pna	fro dyz pgd
lgh lqx ygj hvu ans2 ykm wry hlq fro ygj icy	ykm wry
hlq wda rlt dyz ans2 icy nvc	icy nvc
tpy ans3 kxd kxd rfm dyz mbi hlq opa	kxd kxd rfm
lhm hvu ans2 opa tpy bhp	opa tpy
hlq tpy nms rlt ans2 wda tpy lqx tpy	wda tpy
tpy rlt ans1 bhp bhp	bhp
fro ygj ans3 wry dyz fro wry kxd icy	wry dyz fro
lhm ans2 pna rfm hvu hlq ygj wry	pna rfm
irg ans1 nvc pna	nvc
wda tpy ans2 opa hlq hlq wda dyq ygj	opa hlq
fro pna ykm mbi ans1 tpy hvu tpy	tpy
ans1 dyz lqx pgd	dyz
tpy ans1 pgd pgd	pgd
dyz ans3 bhp ohx nvc	bhp ohx nvc
nvc hvu fro nms ans1 icy kxd hir pgd tao	icy
ans2 rlt pna tpy lhm	rlt pna
tao hlq ans2 rlt kxd dyq lgh dyz	rlt kxd
wry ans1 god nms hvu wry	god
ans2 ykm lhm mbi icy	ykm lhm
ohx rfm bhp nvc ans3 wda dyq nvc dyq	wda dyq nvc
dyq ans2 lgh kxd	lgh kxd
nms wda ans1 lhm rlt nms	lhm
hvu ans2 lgh hvu	lgh hvu
lhm kxd ans3 rfm ykm hvu kxd	rfm ykm hvu
kxd wry tao wda ans2 god ygj wry pgd icy	god ygj
ans3 irg hvu tao rlt bhp nvc irg	irg hvu tao
rlt ans2 pna fro pna hvu wry	pna fro
dyz dyq ans3 pna ohx pna fro mbi dyz irg	pna ohx pna
wda dyz nvc hvu ans2 dyq ygj wda mbi	dyq ygj
wry ohx ans3 nms hcx ygj ykm	nms hcx ygj
tpy ans2 ykm god	ykm god
hir rfm ans2 hvu ohx pgd hir nms	hvu ohx
ans3 rfm ygj tao icy	rfm ygj tao
hcx ans2 nms opa bhp fro fro tpy	nms opa
rfm hvu hlq nms ans2 rlt lhm dyq rfm hir lhm	rlt lhm
hcx tpy icy nvc ans1 hir icy tao irg hir	hir
ans3 wry tao wda	wry tao wda
tpy hcx rlt ans2 nms hir rlt icy	nms hir
ans2 bhp bhp	bhp bhp
hlq mbi ans3 rlt hlq rlt	rlt hlq rlt
wry opa ans3 pna pgd god opa lhm	pna pgd god
wry ans2 ohx ygj dyz irg irg kxd	ohx ygj
wry rfm ans1 mbi tao	mbi
lqx tpy opa ans2 pna dyz hir kxd hlq	pna dyz
dyz lqx dyz ans1 dyz	dyz
ans3 dyq rfm irg lgh	dyq rfm irg
kxd rfm wda ans2 ygj lqx hvu hvu pna lqx	ygj lqx
hir hir rlt ans2 god dyq tpy opa ykm	god dyq
ans2 pgd kxd fro tpy hvu fro	pgd kxd
kxd ygj ykm ans2 lhm ohx	lhm ohx
tao fro ans2 bhp rlt opa	bhp rlt
ans2 ohx kxd hvu	ohx kxd
hcx ans3 tpy hlq hir icy mbi lhm	tpy hlq hir
tao lhm rlt hlq ans1 opa rlt	opa
hvu hir opa mbi ans3 rfm dyz lqx mbi hcx nvc	rfm dyz lqx
nms rlt ans3 opa nms nms lhm hlq hir	opa nms nms
hvu pgd fro hir ans2 fro lhm	fro lhm
ans3 wry hcx icy	wry hcx icy
dyz bhp ans1 fro mbi	fro
hcx hcx dyq rfm ans2 wda wda ykm	wda wda
fro ans2 wry rfm	wry rfm
ans3 lgh lqx tpy dyz hlq lhm lqx	lgh lqx tpy
pgd hir bhp nms ans2 dyz hlq tao icy god tpy	dyz hlq
icy irg bhp tao ans1 tpy pna	tpy
irg dyq mbi dyq ans3 ohx tao god ygj wda opa irg	ohx tao god
ans2 kxd lgh rfm wry pgd	kxd lgh
fro lgh lhm ans3 rfm lqx hir wda	rfm lqx hir
nms rlt ygj ygj ans1 dyz irg	dyz
ans3 wry hcx ykm tpy	wry hcx ykm
ans2 ygj nms rlt nvc mbi rlt	ygj nms
ans3 nms pgd pgd icy fro nms	nms pgd pgd
wry icy fro ans2 wda dyq hvu rfm tao	wda dyq
ans2 god hlq ykm	god hlq
wry hir wda opa ans1 wry opa dyz	wry
ans3 kxd hlq ygj	kxd hlq ygj
hvu ohx mbi ans1 pna lqx rfm	pna
hcx dyq ans3 lqx tpy wda lqx mbi lhm	lqx tpy wda
ans2 irg god hir	irg god
ykm lhm ans3 irg hir ygj rlt wda	irg hir ygj
ans3 hlq rfm hlq rlt ygj nms	hlq rfm hlq
lgh rlt ans2 dyq tpy hlq lhm	dyq tpy
nms bhp ans2 icy god wry fro	icy god
tao fro ygj ans3 lhm fro hlq tao	lhm fro hlq
opa lqx hlq hir ans3 hlq lqx dyq nms	hlq lqx dyq
ans3 lgh tao pgd irg tpy	lgh tao pgd
ans2 hvu rfm fro hir pna	hvu rfm
nvc irg irg ans1 kxd	kxd
ans3 pgd lqx wry nvc	pgd lqx wry
ygj opa ans2 mbi hir	mbi hir
hvu ans2 lhm tao tpy fro	lhm tao
icy pna nvc lqx ans3 wry rlt mbi mbi	wry rlt mbi
lgh ans3 ykm god dyz ygj wry dyz	ykm god dyz
ans1 ykm hir ykm kxd	ykm
ohx dyz ykm ans2 hcx icy bhp icy	hcx icy
nvc tpy ohx ohx ans2 pgd bhp	pgd bhp
ygj ans2 lqx god opa tpy	lqx god
god ans3 hir ykm hvu wda pgd	hir ykm hvu
ans1 pna pna tpy	pna
hlq pna lqx ans3 lhm god lqx lqx	lhm god lqx
kxd nvc ans1 dyz god ykm nvc lgh	dyz
hir fro ans2 fro tao lhm tao	fro tao
opa ans2 god bhp nvc	god bhp
god icy ans2 wda hcx	wda hcx
fro tpy rlt lgh ans1 lqx pgd	lqx
tpy lqx wry god ans1 bhp wry rlt hir	bhp
dyz ygj opa lqx ans3 opa lqx lhm hcx hir	opa lqx lhm
lhm opa ans2 hcx lhm lhm bhp	hcx lhm
rfm ans1 tpy irg kxd	tpy
icy ans1 icy	icy
dyq ans1 hvu pgd dyz nms tpy	hvu
wry god ans3 nms lgh god rfm	nms lgh god
rfm nms ans3 god pgd tao hcx lgh	god pgd tao
opa dyz lgh kxd ans2 hir lhm opa nvc lgh pna	hir lhm
opa dyz ans1 hcx opa opa hir hcx	hcx
tao wry ans1 nms	nms
pna ans2 lqx god kxd	lqx god
icy irg dyq dyq ans3 hlq mbi dyz rfm opa	hlq mbi dyz
ohx hlq ygj ygj ans2 rlt wry pna lgh ygj	rlt wry
ans3 hvu bhp fro mbi god pgd	hvu bhp fro
lqx ans3 wry nms lhm	wry nms lhm
dyz pna hcx mbi ans3 lqx opa dyz pna bhp pgd nms	lqx opa dyz
pgd hvu ans2 god lhm hlq dyz icy rlt	god lhm
fro ans2 pgd god	pgd god
hcx bhp ans2 tpy icy ygj opa	tpy icy
hvu tpy wda ans1 hcx	hcx
pgd dyz tpy hcx ans3 god lqx ykm	god lqx ykm
ans1 ykm hir lhm nms wda	ykm
lqx ans2 nms opa irg fro god	nms opa
ans2 irg tao tao	irg tao
opa nvc dyz lqx ans1 ohx	ohx
ygj ans3 pgd ykm lgh ykm pgd ohx	pgd ykm lgh
ans2 hir pna kxd hir rfm	hir pna
ans1 nms	nms
ygj ans3 lqx ohx dyq nms nvc	lqx ohx dyq
tpy ans3 dyq pna bhp lhm god	dyq pna bhp
ans1 hir	hir
ans1 dyz rlt ykm bhp	dyz
rfm kxd ans3 hlq mbi dyq dyq	hlq mbi dyq
ans3 ykm fro lqx	ykm fro lqx
rfm ykm hvu ans2 irg bhp wda	irg bhp
hvu hlq icy ans2 wda hir nms opa	wda hir
bhp god kxd ans2 dyz rlt hir wry	dyz rlt
mbi hir ans3 fro hvu kxd tao dyz ykm tao	fro hvu kxd
ygj hlq wry ygj ans3 irg rlt ykm god	irg rlt ykm
ohx kxd mbi hlq ans2 rlt lhm irg ohx ygj dyz	rlt lhm
hvu kxd ans1 dyz	dyz
ans2 rfm bhp	rfm bhp
nms pna kxd ans3 opa hvu pna	opa hvu pna
icy bhp hcx ygj ans3 bhp ohx hcx pgd	bhp ohx hcx
lhm ans3 hvu hlq nvc hcx wry irg	hvu hlq nvc
tpy ans3 kxd mbi tpy	kxd mbi tpy
ans2 bhp bhp hcx dyq dyq wda	bhp bhp
icy tao lqx ans2 bhp pna hir fro kxd	bhp pna
wry dyz dyq mbi ans1 opa wry hcx opa	opa
bhp dyq ohx dyq ans1 hlq pna dyq opa opa	hlq
pgd god tao god ans1 lqx dyq ohx tpy mbi	lqx
ans2 ohx lqx hcx	ohx lqx
ans1 ygj pna hvu bhp nvc	ygj
mbi wry hcx ans1 ykm rlt ykm dyq	ykm
hvu ygj wda opa ans2 hcx hvu	hcx hvu
rlt wry tao ans1 ykm	ykm
wda nvc tao fro ans2 lgh tpy ohx	lgh tpy
ans3 ygj wry god wry	ygj wry god
hir kxd ans3 kxd lqx dyz hlq lgh nms	kxd lqx dyz
pna lqx nvc ans1 lhm	lhm
dyq hcx ans1 ohx irg kxd lqx ohx	ohx
nvc ans1 pna fro	pna
lhm mbi ygj hcx ans3 hcx hcx mbi	hcx hcx mbi
ans1 dyq	dyq
icy fro bhp ans2 lgh pgd irg bhp ygj	lgh pgd
irg hvu dyz ans2 bhp bhp dyq lgh nvc icy	bhp bhp
wry bhp ans2 lhm ohx pna nvc kxd	lhm ohx
pna pna icy ans2 ygj hir lgh tpy hcx	ygj hir
opa hir hcx hvu ans3 god hir mbi hvu hlq	god hir mbi
god ans2 mbi dyz ygj	mbi dyz
wry ans3 nvc fro bhp	nvc fro bhp
ygj ans3 ygj nvc opa nms nms	ygj nvc opa
opa pgd pna ans3 kxd god nms	kxd god nms
bhp hcx hcx opa ans1 ohx	ohx
wda opa ans2 hlq rlt lhm hvu bhp wry	hlq rlt
rlt lhm lhm ans2 bhp ygj opa ohx	bhp ygj
ans2 pna lqx lqx	pna lqx
lhm ans1 nms rlt fro	nms
nms irg opa ans3 hcx lqx god nvc pna opa god	hcx lqx god
ans2 fro ohx wda	fro ohx
ykm hlq ans3 rlt rfm hlq ykm	rlt rfm hlq
ans3 opa kxd lqx kxd dyz nms	opa kxd lqx
pna ykm ans1 nvc wry hir wda irg	nvc
wda nms irg icy ans1 dyz	dyz
tpy ans1 tpy hcx ygj	tpy
icy fro ohx nvc ans2 bhp hvu bhp ygj	bhp hvu
ans2 tao lhm ykm lgh hvu mbi	tao lhm
nvc ans1 rlt hvu	rlt
nvc wry ans3 lhm pna tpy hlq hlq opa	lhm pna tpy
hcx bhp ans3 ohx nvc opa fro nvc	ohx nvc opa
lgh ans2 wry dyq	wry dyq
ohx ykm hlq ans3 rlt lgh pgd	rlt lgh pgd
icy wry opa ans2 lqx pgd ykm tao ykm nms	lqx pgd
ans2 nvc dyz tpy	nvc dyz
hvu wry tao ans3 opa tao lgh pna nvc fro wda	opa tao lgh
ans2 mbi wry	mbi wry
icy ohx ans3 mbi lgh tpy rlt hlq hcx	mbi lgh tpy
lhm tao ans2 god pgd rfm ohx rfm pna	god pgd
rlt wry tao ans3 icy icy lgh pgd pna	icy icy lgh
bhp nms god opa ans1 dyq	dyq
dyz pgd ans3 wda hvu ykm tpy hcx	wda hvu ykm
mbi bhp ohx ans2 nms icy wry	nms icy
rlt irg hcx ohx ans1 pna wry tpy kxd	pna
rfm tpy ans1 opa ygj wry fro irg	opa
rfm god ans3 lhm ygj hcx lgh rfm	lhm ygj hcx
tpy ans3 rfm rlt lgh icy fro kxd nvc	rfm rlt lgh
ans2 tpy hvu wda lqx	tpy hvu
rlt wry lgh ans2 hvu dyz ohx icy	hvu dyz
ans3 irg opa wda dyz hir	irg opa wda
pgd tpy ans2 hir tao	hir tao
hcx hcx ans1 fro	fro
nvc bhp ans2 pna mbi lqx	pna mbi
lhm ygj hcx ans1 wry nms nms	wry
hir nms fro ans1 dyz	dyz
dyq opa bhp hlq ans3 wry rlt ykm mbi	wry rlt ykm
hvu dyq hlq ans3 mbi irg tao tao	mbi irg tao
fro bhp ans2 lqx mbi ykm lqx mbi irg	lqx mbi
ykm ygj opa ans1 ykm	ykm
tpy tao hvu ans2 tpy nvc bhp hcx hcx	tpy nvc
ans3 lhm opa ykm lhm god	lhm opa ykm
ans3 dyz tao kxd rfm nms hir tao	dyz tao kxd
ans2 dyz ygj rlt pna	dyz ygj
lhm bhp dyq ohx ans2 tpy opa mbi hir tao hvu	tpy opa
bhp hcx ans2 pgd ohx icy hcx	pgd ohx
ykm ygj god nms ans1 kxd	kxd
ans2 god hlq	god hlq
pna fro ans1 nms mbi hlq rfm	nms
hvu ans1 nms icy rlt bhp	nms
lgh ohx ans3 irg dyz rfm dyq icy dyq	irg dyz rfm
ans3 ohx ygj ykm irg mbi hir	ohx ygj ykm
ans3 hvu tao kxd fro opa dyz hcx	hvu tao kxd
hlq icy ans2 hlq wry opa lqx lqx dyz	hlq wry
icy ans1 lgh dyq hlq hlq	lgh
lgh lhm hcx ohx ans3 lgh hlq lhm pna	lgh hlq lhm
wry bhp hvu lqx ans2 nms rlt wry lgh hvu irg	nms rlt
rfm god ans3 tao ohx fro tpy	tao ohx fro
ans1 kxd ygj pgd	kxd
kxd ans1 dyq icy bhp pna wry	dyq
ygj pna lqx ygj ans1 opa pna	opa
ykm rfm kxd ans2 wda nvc bhp lhm tao ykm	wda nvc
pna ans2 pna bhp ykm hlq tao mbi	pna bhp
fro ans1 kxd lgh hcx rfm	kxd
ans3 ohx ygj rlt hlq kxd lqx irg	ohx ygj rlt
ans2 nms opa tao lgh	nms opa
hir ans3 kxd icy dyz hlq hvu pna	kxd icy dyz
nms lhm pgd ans2 kxd pgd hlq lgh fro	kxd pgd
hlq ans1 irg ygj opa	irg
mbi wda bhp hir ans2 tao god rlt nvc fro opa	tao god
nvc nvc rlt ans1 dyz pgd	dyz
ans2 nvc dyq irg fro	nvc dyq
ans3 fro rlt bhp dyq opa god	fro rlt bhp
wda tao ans1 opa icy fro irg pna	opa
hlq hvu mbi ans2 dyq fro tao fro tao	dyq fro
lgh mbi ykm ygj ans2 kxd hlq ygj	kxd hlq
ans3 opa ykm wry tpy hcx	opa ykm wry
rlt hir rfm irg ans1 god pna nvc	god
mbi lhm ans1 lqx bhp	lqx
mbi ans1 god hcx pna god hir	god
ans2 rlt nms dyq nms tpy	rlt nms
rlt bhp lgh fro ans1 dyz rfm kxd pna lhm	dyz
ans2 nms dyq fro	nms dyq
bhp ans2 ygj hir	ygj hir
ans2 dyq nvc hcx kxd	dyq nvc
bhp ans2 mbi hir irg dyz pgd hir	mbi hir
ans2 god lqx lgh lhm dyq kxd	god lqx
opa pgd mbi ans2 irg ohx kxd wda	irg ohx
dyz pna ans3 mbi hvu pgd god lqx irg	mbi hvu pgd
hvu tao pna ans1 irg ohx rfm wry hcx	irg
wda nms pna rlt ans3 ohx pna dyz hlq opa god god	ohx pna dyz
rfm rfm ans2 ohx hvu ykm	ohx hvu
hvu wry bhp pna ans3 tpy hlq hvu tpy nms ygj nms	tpy hlq hvu
ykm ohx nms bhp ans3 lhm ygj ygj kxd pna	lhm ygj ygj
fro ans1 hir dyz nms rlt mbi	hir
tao irg dyq rfm ans3 bhp wry ykm irg ykm	bhp wry ykm
lhm opa ans2 nvc opa	nvc opa
pgd rlt rlt ans3 ykm rfm hvu rlt	ykm rfm hvu
fro dyz hlq pgd ans3 lgh lgh icy	lgh lgh icy
hvu ohx opa ans3 nvc god tao irg nms bhp irg	nvc god tao
lqx mbi hlq hcx ans3 ygj tao fro ygj icy	ygj tao fro
ygj wry ans1 opa bhp	opa
pna ans1 hlq	hlq
lhm fro god hir ans2 nms nms hcx ykm	nms nms
fro hvu ans3 ykm rfm opa	ykm rfm opa
mbi ans1 tpy rfm nvc ykm lgh	tpy
ans1 lhm tpy nms dyq	lhm
rfm ans1 lqx hvu dyz ygj	lqx
hir rfm nvc ans1 hvu	hvu
ans3 hvu pna wda hir pgd hvu	hvu pna wda
hir kxd ans1 mbi pgd mbi hcx wry	mbi
ans1 kxd nvc rfm lgh	kxd
icy ohx fro ans3 pgd rfm tpy lqx irg tpy	pgd rfm tpy
hvu nms ans1 opa	opa
hvu ans1 bhp	bhp
hlq nvc ohx ykm ans2 rfm lgh lgh dyz opa hlq	rfm lgh
pna wda ans1 lqx	lqx
rlt ans3 rfm dyq rfm	rfm dyq rfm
dyz ans2 hlq nvc opa lgh hvu bhp	hlq nvc
lqx tao tao ans1 tpy tao lhm nms	tpy
lqx dyz ygj ans3 hir lqx rfm tao dyz mbi	hir lqx rfm
rfm opa ans2 god god hlq god wda	god god
lqx dyq ykm ans3 hlq icy lgh	hlq icy lgh
nvc icy ohx icy ans1 lgh	lgh
ykm mbi fro ans2 nvc nms lhm lqx kxd ygj	nvc nms
rfm rfm hir ans1 nvc	nvc
dyq hir ans3 kxd bhp wry nvc irg wry	kxd bhp wry
rlt hcx ans3 opa hvu icy	opa hvu icy
ans3 fro lqx rlt	fro lqx rlt
ans2 ygj hvu nms	ygj hvu
ans3 icy mbi lgh irg	icy mbi lgh
ykm ohx bhp dyz ans1 lqx	lqx
ans1 hcx	hcx
tao pgd ans1 pna tpy bhp	pna
tpy pna ans2 rfm nms ohx	rfm nms
lgh ans2 icy ykm ykm	icy ykm
ygj kxd ans3 god lhm fro lgh	god lhm fro
kxd pna wda rfm ans3 wda nms dyq	wda nms dyq
opa ans3 lhm hlq hir lqx hlq ygj mbi	lhm hlq hir
opa irg icy ans1 rfm nvc rfm hlq god	rfm
fro ans2 mbi lgh wry wda pna	mbi lgh
icy nvc ans3 opa hir ygj	opa hir ygj
ans3 wry hvu lhm dyz hlq	wry hvu lhm
opa rfm ans3 fro wda pna rfm ygj hlq ykm	fro wda pna
ans2 tao fro opa nms	tao fro
ans1 lgh ohx hvu kxd god	lgh
pgd lhm ans1 irg tpy hvu nms pgd	irg
mbi lhm nms ans2 rfm wda wry hcx irg	rfm wda
wry lqx ygj ans1 icy dyz	icy
icy irg dyq ygj ans1 dyq	dyq
ans3 dyz ykm rfm	dyz ykm rfm
ohx ans1 opa hlq irg	opa
lgh dyq ans1 tao ygj ohx ohx ykm	tao
kxd ohx lqx tpy ans3 tpy dyz kxd	tpy dyz kxd
pna god ans2 ohx ygj pna ohx lhm	ohx ygj
ykm ans1 rfm dyz opa icy	rfm
lgh ans3 wry hvu icy fro hvu hlq	wry hvu icy
ykm ans1 mbi nms nms icy	mbi
ans1 dyq	dyq
rlt lgh god ans3 hcx kxd hlq hlq hcx	hcx kxd hlq
tao rlt irg ans2 hvu irg wda nms ohx fro	hvu irg
lhm fro ans3 wry nvc lgh	wry nvc lgh
dyq ygj hir rlt ans2 rlt hvu	rlt hvu
icy ans2 rlt lqx bhp wda mbi pgd	rlt lqx
opa dyq god ans3 lhm ohx ohx opa dyz god bhp	lhm ohx ohx
ohx opa ohx ans1 hcx god rfm hcx rfm	hcx
mbi god hvu wry ans2 ohx hcx irg dyq	ohx hcx
icy hvu ykm wda ans3 nvc pgd ygj lhm dyz nvc	nvc pgd ygj
tpy ans1 kxd icy	kxd
ans1 dyz pna	dyz
hcx ans3 kxd hcx rfm hcx rlt	kxd hcx rfm
nvc dyq ykm mbi ans3 wry kxd fro ygj kxd hcx	wry kxd fro
god god wry ans1 pna pna nvc	pna
nms ans3 lqx pna nms lgh rfm	lqx pna nms
lgh ans3 nvc icy ygj pgd bhp hvu wry	nvc icy ygj
rlt kxd ans1 icy	icy
hlq dyq irg ans1 dyq hir hcx fro	dyq
rlt ans3 hcx hir mbi dyq kxd ohx hlq	hcx hir mbi
irg pna ans1 lhm fro nvc	lhm
nms ans1 wda icy lqx	wda
wda irg wda hcx ans3 opa wry tao ykm	opa wry tao
fro dyz dyz dyz ans3 hir icy lqx bhp dyz tao ygj	hir icy lqx
ohx ans1 icy	icy
tpy wry ans1 hcx nvc dyz	hcx
wry ans3 dyq opa nvc kxd pgd	dyq opa nvc
ans3 nvc hlq ykm tpy	nvc hlq ykm
pgd hir mbi ans2 lhm kxd rlt lgh opa	lhm kxd
rfm nms ans3 icy wry ohx dyq hcx opa rlt	icy wry ohx
dyz pgd ans1 hir opa ygj	hir
god icy rlt ans3 nvc hcx pna dyq fro ohx hvu	nvc hcx pna
nvc wry ans1 kxd god	kxd
dyz ykm pna ans1 lqx nvc lqx	lqx
kxd mbi ans2 pgd ykm lgh	pgd ykm
lgh mbi hvu lqx ans3 lgh nvc god kxd ygj nms opa	lgh nvc god
ykm god lhm ans2 ykm opa dyz nms bhp	ykm opa
pna ykm rlt wda ans2 rlt pna	rlt pna
irg tao ans1 ohx rfm nvc ykm dyz	ohx
tpy ans2 wda bhp tpy dyz hir icy	wda bhp
icy fro ans3 hlq fro pgd	hlq fro pgd
mbi dyz ans1 tpy	tpy
nvc lgh pna tpy ans1 pna lgh ygj hvu	pna
ans1 rlt nvc	rlt
ans3 irg lhm mbi lgh nms	irg lhm mbi
hvu god kxd ans1 rlt rfm	rlt
tao ohx irg pgd ans1 fro	fro
ans1 rfm	rfm
lhm ans2 ohx lqx rlt	ohx lqx
lqx rfm dyz ans1 ykm pna rfm wda ygj	ykm
wry fro hcx ans2 lhm fro rfm pgd tao	lhm fro
ans2 bhp wda tpy	bhp wda
ans3 hcx irg opa hir dyq wry nvc	hcx irg opa
lgh opa ans2 rfm lqx pna lhm	rfm lqx
icy ans3 tao hlq mbi	tao hlq mbi
hlq nms ans1 hcx	hcx
lqx ohx rlt rlt ans3 bhp pna irg	bhp pna irg
tao nms hvu ohx ans3 hvu kxd ohx lqx tpy tpy	hvu kxd ohx
wry mbi ygj lqx ans2 hcx dyz kxd tpy hvu kxd	hcx dyz
god ygj rlt bhp ans1 hvu wry ygj pna ygj	hvu
dyz hlq ans3 lgh tpy dyz nms ohx ohx irg	lgh tpy dyz
tpy icy ans3 bhp hcx fro rlt	bhp hcx fro
opa fro ans3 rlt fro hir	rlt fro hir
rfm dyq lgh bhp ans2 lgh pna tpy tpy hcx	lgh pna
god icy nvc icy ans1 hir lhm ohx icy	hir
ans1 ygj hlq	ygj
hcx nvc hcx ans1 god nms opa	god
wry hcx kxd opa ans3 kxd rfm rlt hir hlq hcx	kxd rfm rlt
opa ans1 hir	hir
icy ohx ans1 hvu rfm fro wry lqx	hvu
hlq irg ykm fro ans1 lqx hvu nvc bhp	lqx
dyq icy nms ans3 bhp dyq fro hvu	bhp dyq fro
nms hvu hlq god ans1 irg ykm	irg
fro lhm lgh hlq ans1 nvc irg dyq ykm	nvc
lhm ans3 nvc hvu kxd pna bhp dyq ykm	nvc hvu kxd
wda rlt hlq hir ans2 dyz rlt ohx rlt	dyz rlt
hir hcx ans3 fro wry ykm bhp	fro wry ykm
lqx nvc tpy hcx ans3 ohx hcx god bhp	ohx hcx god
ykm lhm ohx hvu ans2 wry fro	wry fro
irg tao hcx dyq ans1 mbi wda rfm hcx	mbi
kxd pgd tpy hvu ans2 hlq rlt lhm nvc tpy	hlq rlt
kxd lgh ans3 icy hvu hcx hlq	icy hvu hcx
ohx ans1 mbi lgh rfm hir lqx	mbi
kxd ans3 nms hcx ohx	nms hcx ohx
ans1 fro hir wda	fro
rlt kxd ans2 tpy rlt hir nvc	tpy rlt
rlt fro ans1 lhm pgd icy lhm dyz	lhm
lgh ohx rfm ans3 rfm lgh lqx tao nvc kxd nvc	rfm lgh lqx
ans1 ygj	ygj
pgd ans3 tpy lgh fro hcx kxd	tpy lgh fro
tao rfm kxd ans3 rfm irg nms dyq wda	rfm irg nms
ykm ykm hvu irg ans3 bhp nvc tpy	bhp nvc tpy
wda hir ans1 rfm	rfm
ygj hvu ans2 dyz irg ykm	dyz irg
rfm lqx tpy rfm ans1 hir lhm hlq ohx	hir
ygj ohx icy kxd ans1 ohx dyz rfm hlq	ohx
pna tpy fro ans3 nms rfm dyq	nms rfm dyq
ans2 hlq wry hir	hlq wry
fro hir hir ans1 nms hir	nms
rlt fro dyq ans3 hir hir pgd	hir hir pgd
ans1 wry ykm ohx	wry
opa lgh mbi ans1 dyz nms kxd	dyz
dyz lgh ans1 tpy	tpy
ans1 mbi wry mbi fro dyz	mbi
fro hvu lgh ans3 fro lgh icy rfm	fro lgh icy
ans2 fro lhm rfm pgd wda ygj	fro lhm
pgd hir dyz ans3 rlt ykm ykm rfm	rlt ykm ykm
nms ans2 god tpy	god tpy
hlq dyz ans1 kxd	kxd
ans2 hir lqx tpy nvc nvc	hir lqx
dyq god hcx ans3 bhp dyq dyq tao pna rlt nms	bhp dyq dyq
ykm kxd bhp ans3 ohx pgd god rfm hcx wry lhm	ohx pgd god
wry ohx ans1 opa nms ygj tao	opa
hlq ans2 nvc dyz ygj	nvc dyz
tao lgh hlq hir ans3 ygj dyz lgh nms dyq lhm ohx	ygj dyz lgh
mbi ans1 hcx wda hcx	hcx
rfm hcx dyz hlq ans3 lqx icy icy ygj kxd	lqx icy icy
tpy dyz lgh wda ans2 hvu tao pna pgd pna	hvu tao
rlt ans2 opa ohx nms icy	opa ohx
tpy ans1 irg	irg
tpy ykm pna lqx ans2 lqx bhp rlt hir lqx lqx	lqx bhp
tao nvc dyz ans2 lhm dyq	lhm dyq
hcx icy lgh ans2 lqx opa kxd dyq opa	lqx opa
rfm ans2 pgd opa irg bhp hcx	pgd opa
pgd god lgh ans2 nms lgh rlt god pna	nms lgh
pna ans3 nvc hcx icy	nvc hcx icy
nvc irg pgd pgd ans2 dyq pna pna	dyq pna
ans1 mbi tao pna	mbi
ans2 wry wda pna	wry wda
ans2 irg lhm lgh icy nvc	irg lhm
icy ygj dyq opa ans3 ykm dyq hcx lhm lhm bhp nms	ykm dyq hcx
tao hcx ans1 god lqx lgh	god
fro wry pgd ans1 hvu nms	hvu
ygj hcx ans1 mbi nms	mbi
mbi opa wry ans3 rlt bhp rfm hcx hlq lhm hlq	rlt bhp rfm
ygj hir ans3 nvc ykm mbi lhm mbi lqx	nvc ykm mbi
ans2 hlq wry	hlq wry
ans2 hvu bhp lqx dyq	hvu bhp
wda hir ohx ans3 bhp irg dyq kxd hlq	bhp irg dyq
ans2 hir lqx	hir lqx
ans2 tpy god ohx opa	tpy god
pgd hir hvu ans1 ykm dyq ygj icy lhm	ykm
icy ans1 hir	hir
rfm ans2 ykm hvu icy pgd	ykm hvu
mbi hir pgd hir ans3 pgd tao mbi fro	pgd tao mbi
ans1 opa	opa
fro ans1 hcx tao	hcx
pgd dyz dyz ans2 lgh wry irg lgh	lgh wry
hvu wda opa ans1 lqx hvu	lqx
dyq nms wda ans1 icy hvu opa god rfm	icy
ans3 hlq bhp hvu	hlq bhp hvu
dyz ans1 lhm tao dyq god	lhm
bhp hvu ans3 hir nvc irg fro irg lhm	hir nvc irg
ans3 nvc bhp lhm fro rfm ygj	nvc bhp lhm
pna ans3 nms rlt ygj nms irg	nms rlt ygj
ans2 nms hcx mbi	nms hcx
rfm tpy tao ans1 god	god
ans3 nms tpy icy	nms tpy icy
pna kxd nvc tao ans2 rfm nms	rfm nms
ans2 rlt nvc kxd dyz lhm icy	rlt nvc
kxd rfm ans2 pna opa	pna opa
ykm wda god ans1 rlt hlq lqx	rlt
mbi ans1 pgd nms lgh lqx	pgd
ans1 nvc nms	nvc
ygj ans1 hir tao dyq hcx	hir
pgd pgd dyq lgh ans3 ygj ykm icy hlq wda dyz	ygj ykm icy
icy lhm kxd ans3 god mbi fro fro bhp	god mbi fro
ans3 ykm hir wda pna dyq ygj wda	ykm hir wda
dyz lqx god ans2 god hvu hcx kxd rlt ykm	god hvu
lhm ans1 dyz irg mbi hvu mbi	dyz
nvc tpy kxd ans3 rfm rlt hcx fro hcx lhm	rfm rlt hcx
ans3 rlt pgd dyq	rlt pgd dyq
tao dyz hir wry ans2 hvu nvc dyz pna wry fro	hvu nvc
lqx pgd hcx mbi ans1 opa ygj icy rfm	opa
lhm rfm ans3 icy irg hlq tao opa	icy irg hlq
opa ohx ykm ans2 fro irg hvu	fro irg
irg ykm nvc ans2 hir hlq	hir hlq
lgh pna kxd ans2 wry dyz	wry dyz
ygj pna kxd nms ans2 rfm mbi nms dyz	rfm mbi
ans1 pna dyq	pna
lgh ans2 wda hir	wda hir
hvu rfm rfm ans2 nvc mbi pgd	nvc mbi
lhm nms ans2 pgd rfm pna wry	pgd rfm
ohx fro hir ans2 rlt hlq hcx hir pna irg	rlt hlq
tao nvc nms ans2 lqx rfm	lqx rfm
ans3 lhm wda lqx	lhm wda lqx
lqx hcx ans3 rlt wry ohx bhp	rlt wry ohx
ans2 opa pgd	opa pgd
dyz dyq ans2 rfm lqx nvc	rfm lqx
hir hvu ans1 bhp pna rfm rlt	bhp
kxd kxd icy fro ans1 tpy ykm lqx	tpy
ans2 tao rlt ykm	tao rlt
hlq lgh hcx lqx ans1 lgh opa	lgh
lqx ans3 fro god wry rfm dyz ygj	fro god wry
ans1 rlt lhm hvu bhp	rlt
ans2 bhp pgd icy nvc pgd god	bhp pgd
dyz lgh ans3 hlq wry tpy	hlq wry tpy
mbi opa pna ygj ans1 icy nms dyz	icy
tao ans2 dyq ygj irg pna nvc hir	dyq ygj
mbi lqx ygj ans2 lhm hcx kxd rfm icy kxd	lhm hcx
ohx ans2 tpy tpy pgd	tpy tpy
tao icy wry ans3 pna nvc lgh rfm rlt ygj god	pna nvc lgh
lqx lhm hcx ans3 hvu dyq hcx ygj rfm nvc	hvu dyq hcx
tpy ans2 bhp fro nvc rfm ohx	bhp fro
hlq ans3 god hvu rlt hcx lqx ygj	god hvu rlt
opa ans2 rlt opa rlt tpy mbi	rlt opa
god god ans3 irg ohx opa	irg ohx opa
dyq god ans3 rlt bhp lqx icy nvc lqx	rlt bhp lqx
hcx tpy lgh lhm ans3 pna kxd hir tpy lqx	pna kxd hir
god nms ans1 wry	wry
lqx ans2 pgd lqx hir rfm	pgd lqx
god irg bhp rlt ans1 bhp wry	bhp
dyz icy ans2 god wda	god wda
tao rfm ans2 dyq pgd	dyq pgd
lqx ans2 kxd opa wda	kxd opa
wry wry ykm ans2 irg hvu lhm tao	irg hvu
ans3 ohx hcx lgh	ohx hcx lgh
opa ans2 kxd hvu	kxd hvu
hlq tpy hir dyz ans2 dyz ygj hlq opa hcx	dyz ygj
ans1 irg opa rlt opa lhm	irg
ygj hlq ans3 bhp lhm dyz ykm wda	bhp lhm dyz
opa kxd ans2 nvc hir rfm	nvc hir
kxd rfm dyz ans1 dyq fro	dyq
irg hvu hvu lhm ans2 pna mbi ykm	pna mbi
tao wda ykm ans2 wry hcx	wry hcx
wry ans3 pgd icy fro kxd	pgd icy fro
ygj ans1 wry lgh fro pna	wry
kxd nms wry ans2 wda nvc opa wda	wda nvc
ygj ans1 hcx hir	hcx
nvc irg ygj mbi ans3 mbi tao hcx pna pna ohx kxd	mbi tao hcx
ans3 bhp irg god	bhp irg god
kxd nvc ans3 dyq hcx hir	dyq hcx hir
wda irg ans3 lhm opa hcx ohx irg tao ygj	lhm opa hcx
lhm tpy rlt ans1 rlt rlt ohx hvu bhp	rlt
ykm fro god ans3 hvu irg lgh kxd tao fro hcx	hvu irg lgh
ans2 hlq hvu ygj rlt nms	hlq hvu
rfm wry lhm lhm ans2 dyq pgd mbi	dyq pgd
lhm ans3 lhm pna nms nvc fro	lhm pna nms
fro pgd irg dyz ans2 ygj ykm hir dyq mbi	ygj ykm
nms rlt tpy pna ans1 hcx fro rfm	hcx
nvc wry hcx tao ans2 bhp ykm lgh opa	bhp ykm
ans1 icy fro rlt hir	icy
hir ohx lhm hir ans3 hvu dyz pna wda	hvu dyz pna
ans2 icy ykm dyz	icy ykm
fro pgd icy ans3 pna hvu hvu wda pna mbi	pna hvu hvu
bhp nvc ans3 lqx tao ykm hlq	lqx tao ykm
hvu ans3 dyz kxd wry	dyz kxd wry
ans2 ohx rlt lhm hvu	ohx rlt
wry pna ans1 mbi lgh hcx kxd ohx	mbi
ans1 dyq	dyq
dyz god tao ans3 lgh lqx god nms mbi	lgh lqx god
nvc ykm hir hir ans2 ygj lgh dyz hvu pna hcx	ygj lgh
god lhm ans1 opa hlq hcx kxd pgd	opa
pna dyz tpy ohx ans3 fro opa hlq lhm nvc kxd ohx	fro opa hlq
ans3 hvu icy dyz nvc lqx god nms	hvu icy dyz
ans1 dyz hcx	dyz
hcx ans1 ohx dyq hir mbi	ohx
ans1 opa pgd dyq ygj hir	opa
ans2 tao wry	tao wry
rlt ans3 tao lqx hvu rfm icy fro lqx	tao lqx hvu
ans2 hvu pna	hvu pna
tao dyz ans1 dyz kxd rfm pgd wda	dyz
hcx ans3 wry hvu wry god ykm ohx wry	wry hvu wry
wda hir opa ans2 ygj god hir icy	ygj god
fro ohx ans1 mbi god bhp pna irg	mbi
pgd mbi hvu ans1 tao pna dyq bhp tao	tao
opa hvu dyq ans1 opa kxd	opa
kxd ygj kxd ans3 hvu irg pgd rfm mbi	hvu irg pgd
nvc ans1 god fro dyz	god
ohx rlt bhp ans3 hlq rfm dyz	hlq rfm dyz
ans3 bhp rlt opa dyq tao	bhp rlt opa
hcx ans3 wda ygj pna pgd	wda ygj pna
tpy wry ans3 hcx icy irg dyz bhp wry	hcx icy irg
lqx ans2 hvu nvc icy hir dyq ykm	hvu nvc
ans1 mbi	mbi
irg rlt ans2 wda pna icy nms hlq	wda pna
rfm wda wry ans1 dyz wry	dyz
ykm tao ans3 opa nms irg mbi tpy tao	opa nms irg
ans1 nms kxd	nms
tpy lhm ans2 hcx hcx tao	hcx hcx
hlq hir wda nvc ans3 lgh ygj lgh lhm rlt lgh	lgh ygj lgh
god lhm lhm irg ans1 rlt irg wda	rlt
god wry icy ans2 ohx rfm pgd hvu ohx ykm	ohx rfm
ans3 wda fro ygj dyq	wda fro ygj
dyz ans2 hvu nvc fro mbi dyz fro	hvu nvc
pgd dyq ans2 god icy	god icy
rfm lqx wry ans1 hir fro wda	hir
icy lgh ans3 hlq mbi pgd hir	hlq mbi pgd
tpy kxd hir nms ans1 lgh hvu wda fro	lgh
hlq hvu ans1 fro pna pgd pgd	fro
lqx pgd lgh ans1 hir tao ykm	hir
dyq ans3 ykm ygj rlt lgh pgd	ykm ygj rlt
ans1 ykm pna	ykm
ans3 lhm dyq mbi nms opa	lhm dyq mbi
pgd hvu ans2 lhm lqx dyq ohx	lhm lqx
hlq opa hcx ans2 god hir lgh	god hir
hir lgh ans2 dyz rfm bhp	dyz rfm
ans2 wda ohx	wda ohx
dyz ans3 irg fro lqx	irg fro lqx
ans1 hir ykm ykm	hir
fro tao ans1 god tao hvu hvu lhm	god
lhm pna ans1 irg kxd bhp	irg
rlt hvu lgh hlq ans3 hlq lgh god bhp tao icy dyq	hlq lgh god
kxd fro dyz bhp ans2 hvu nms	hvu nms
icy ans3 icy fro fro mbi bhp	icy fro fro
lgh ohx ans2 icy icy god mbi tao	icy icy
ohx pna ans2 dyz bhp rfm lqx hvu icy	dyz bhp
bhp ans3 icy nvc hir	icy nvc hir
kxd opa ohx ans1 dyq pgd wry wda	dyq
dyz hcx bhp ans2 kxd rfm lhm irg hlq lqx	kxd rfm
ans3 pgd ygj kxd lhm wry icy	pgd ygj kxd
tao hir ans2 hcx dyq tpy	hcx dyq
pna ans3 pgd nvc dyq irg	pgd nvc dyq
lqx icy rlt fro ans1 wry dyz bhp	wry
bhp ans3 god opa rfm lhm kxd hlq lqx	god opa rfm
ans1 opa	opa
lhm lqx pna hcx ans1 hir kxd hlq	hir
wda wda ans2 nms wry tao	nms wry
opa irg ans2 nms lqx god hlq bhp wda	nms lqx
rfm bhp ans1 lqx	lqx
ans2 wda hir nvc hlq wry pgd	wda hir
rlt ykm opa ans1 opa nms ykm hlq wda	opa
ans2 ykm irg wda kxd rlt	ykm irg
icy ans1 lhm hvu lqx hvu ygj	lhm
ohx pgd ygj ans1 lgh mbi ygj rlt kxd	lgh
opa pgd icy ans1 lhm	lhm
dyz dyq ans1 dyz lhm hir	dyz
pgd bhp ans3 lgh hvu pgd pgd opa ohx	lgh hvu pgd
rlt rlt ans3 ykm dyz irg	ykm dyz irg
rlt wda ans3 tao lqx nms lgh pna fro opa	tao lqx nms
ohx dyz icy ans1 wda lgh	wda
hcx pgd rlt ans3 lqx fro bhp dyz	lqx fro bhp
pna ans2 ohx wry bhp ykm opa	ohx wry
hlq wry ans3 hvu kxd pgd fro	hvu kxd pgd
nms bhp ans1 lgh rfm wry	lgh
rfm nms irg ykm ans3 fro nms kxd icy rfm	fro nms kxd
ans2 kxd fro rlt	kxd fro
god icy nvc hir ans1 ohx	ohx
ans3 pna ykm nms	pna ykm nms
hlq ans1 wry hlq	wry
ans2 tpy tao hcx hir tao	tpy tao
wry ygj pna ans2 ohx tao nvc dyz kxd fro	ohx tao
pna ygj nms lhm ans3 wda pna fro god hcx nvc	wda pna fro
nms god pna ans3 rfm nvc bhp fro lgh bhp	rfm nvc bhp
icy tpy dyq ans3 dyz pgd pgd tao mbi nms	dyz pgd pgd
dyq hlq ans1 dyq mbi lqx lqx hlq	dyq
dyq ans3 bhp god hcx rlt ygj	bhp god hcx
ans1 fro lgh nvc	fro
ans3 nms hlq wry hlq hir hlq rlt	nms hlq wry
ans2 nms fro nvc lgh ykm	nms fro
ans3 ykm hir ykm kxd	ykm hir ykm
dyz pna mbi pgd ans3 rlt opa hvu kxd rlt	rlt opa hvu
hlq ans3 fro hir tao rlt tao	fro hir tao
god irg ans2 hir dyz opa	hir dyz
dyz rlt ans2 wda lqx lhm irg	wda lqx
hir opa lhm ans3 lgh icy icy	lgh icy icy
icy wda ans2 lgh bhp dyq	lgh bhp
ans2 rlt wda pna bhp	rlt wda
wry ans1 irg ohx kxd fro bhp	irg
ykm dyz wry ans3 dyq lgh rfm hvu hcx god	dyq lgh rfm
nms kxd ans1 ohx	ohx
ygj hlq bhp ans1 dyq pna lhm hcx	dyq
ygj pna dyz ans1 hir nvc	hir
opa ans1 ohx wda tao fro bhp	ohx
god wry ans2 hlq wry lqx icy	hlq wry
god dyq ans2 wry irg mbi kxd rlt	wry irg
icy mbi lgh tao ans2 wda irg pgd	wda irg
kxd mbi ans2 dyz lgh	dyz lgh
wda ans2 icy nvc mbi	icy nvc
opa icy ans3 god fro mbi rfm mbi ygj tpy	god fro mbi
ans3 kxd god wry	kxd god wry
kxd hcx god nvc ans2 hir lhm	hir lhm
dyz pna rlt ans2 hcx hlq god lqx lqx	hcx hlq
ans3 ykm opa lqx pgd pgd rlt hcx	ykm opa lqx
ohx ans1 hcx	hcx
tpy wda pgd ans3 fro dyz bhp	fro dyz bhp
rfm mbi ykm ans2 kxd pna hcx ygj	kxd pna
hcx dyz opa ans3 pgd dyz hir bhp tpy	pgd dyz hir
tpy rlt hvu kxd ans3 pgd wry wry opa	pgd wry wry
lqx ans1 dyz lqx wda fro tao	dyz
rlt hcx dyq ans1 fro nvc	fro
hcx mbi mbi pgd ans2 lqx lgh fro	lqx lgh
tao icy ans2 kxd hlq lqx	kxd hlq
ans3 hlq rfm ygj nms pgd wda nms	hlq rfm ygj
dyq tao opa ohx ans3 dyz tao kxd rfm icy dyz	dyz tao kxd
ans1 rfm tao tao hvu wry	rfm
pgd ans2 god opa nms god bhp pna	god opa
nms ans2 icy ohx	icy ohx
ans2 mbi nms rlt dyq hcx	mbi nms
icy mbi dyq ans3 mbi hir tao wda lhm	mbi hir tao
ans3 ygj dyq icy dyz mbi	ygj dyq icy
ygj ohx hvu ans3 rfm lqx dyz	rfm lqx dyz
lqx hir ans2 wda god lhm ykm dyz	wda god
tpy ans1 dyq pna	dyq
rlt ans2 bhp pna god	bhp pna
pna tpy ans2 icy tpy	icy tpy
icy pna ans1 rfm	rfm
pna tpy ans3 opa god hvu nms ohx nvc ykm	opa god hvu
wry hlq ans1 icy pgd pna	icy
rfm ans3 wda bhp pna ygj	wda bhp pna
ygj nvc ans3 irg dyq nms	irg dyq nms
hvu hvu opa bhp ans2 kxd ygj	kxd ygj
mbi lgh ans2 hcx kxd hlq icy tao ykm	hcx kxd
fro icy rlt dyq ans3 bhp bhp hvu tao kxd dyz	bhp bhp hvu
wry mbi ans3 nvc dyz icy rfm hcx	nvc dyz icy
hcx dyz ans2 ohx ygj lhm irg pgd	ohx ygj
fro wry tao ans1 bhp icy pgd	bhp
kxd rlt lgh bhp ans2 lqx tpy kxd hvu lhm	lqx tpy
hlq irg god ans2 tao hvu fro fro ygj rfm	tao hvu
ans1 hir bhp	hir
ans3 hir hcx ykm ygj tao	hir hcx ykm
ans3 wry hvu god hvu	wry hvu god
lhm ans2 pgd lqx hir ohx kxd	pgd lqx
rlt lhm dyq ans1 mbi lhm	mbi
kxd rfm god ans3 hcx hcx ykm fro	hcx hcx ykm
dyq pgd ans3 hvu bhp ygj	hvu bhp ygj
nms ans3 rlt ohx god lgh opa	rlt ohx god
hir opa rfm ans3 lhm nms hlq dyz rlt	lhm nms hlq
ans1 dyq pgd	dyq
nvc tao ans2 mbi tpy ohx opa	mbi tpy
ans2 hlq mbi tpy	hlq mbi
ans3 hcx hlq pgd tpy pgd god dyz	hcx hlq pgd
fro kxd ans1 nvc lqx ohx ykm	nvc
ans3 tao rlt dyz rlt wry	tao rlt dyz
ans3 wda nvc tpy nms	wda nvc tpy
tpy ans3 bhp tao tao	bhp tao tao
irg ans1 hvu mbi hir lgh lhm	hvu
wry dyq lqx ans3 pgd pna pna ykm	pgd pna pna
opa tao pgd ans3 rlt tpy kxd	rlt tpy kxd
irg ans1 god pgd	god
ohx icy wry kxd ans3 ohx wda pgd hir	ohx wda pgd
fro ans1 wda	wda
wda opa fro ans3 rfm pgd lhm fro ygj	rfm pgd lhm
icy kxd rfm ans3 lgh icy tpy ykm tao rfm	lgh icy tpy
hlq lhm god ans2 hcx wda hcx	hcx wda
ygj ans2 opa pna dyz irg tpy rlt	opa pna
lqx wda wda rlt ans2 rfm rfm tpy pna	rfm rfm
wda icy ans1 irg rlt	irg
ans1 ohx wda	ohx
hir hir ans3 fro lqx lqx hvu hlq pgd	fro lqx lqx
hcx ans2 nms kxd god god tao icy	nms kxd
wry ans3 bhp dyq fro	bhp dyq fro
pgd hir pna ans1 kxd hir fro ygj hir	kxd
ans3 irg ykm tpy tpy pna hlq	irg ykm tpy
lhm lgh wda ans3 dyz god icy fro irg	dyz god icy
ans2 icy rlt	icy rlt
pna rfm lhm ans2 icy icy nms	icy icy
god opa ans1 pgd kxd pna	pgd
ohx tpy lhm tpy ans3 irg tao pna	irg tao pna
tpy nms ans3 lhm opa wda god hcx	lhm opa wda
ohx opa mbi ans1 icy ykm opa bhp pna	icy
ans1 ygj irg mbi opa	ygj
nms ygj ans3 kxd lqx nms kxd	kxd lqx nms
tpy ans3 rlt mbi nms god kxd pna nms	rlt mbi nms
ans2 god god rlt opa wry bhp	god god
ygj pgd tao god ans1 kxd	kxd
ykm tpy ans3 dyz wry god nms lgh wry	dyz wry god
hvu hvu rfm ans1 hir irg ygj	hir
wry god hvu bhp ans1 lqx god ygj nvc ohx	lqx
dyz tpy ans1 dyz wda tao ygj rfm	dyz
pgd wry ans1 hcx lgh pgd lgh	hcx
tao hir ygj lqx ans2 nvc rlt nms	nvc rlt
lqx ans2 dyz nvc ykm	dyz nvc
mbi wda bhp ans1 opa tao ygj	opa
kxd ans1 kxd	kxd
ykm lqx rfm irg ans2 lqx opa lhm	lqx opa
pna wda ans1 lqx icy rlt pgd dyq	lqx
tao rlt ygj tpy ans3 icy dyz tpy lhm rlt hvu opa	icy dyz tpy
hvu ans1 lqx wry	lqx
dyq lqx hcx lhm ans1 nvc rfm rfm dyq	nvc
ans2 kxd kxd wry	kxd kxd
lgh lhm pna ans1 hcx	hcx
ans3 ohx tpy lhm pgd	ohx tpy lhm
tao dyq tpy ygj ans1 dyq	dyq
tao kxd dyq ans3 tao fro wry hcx ohx hvu	tao fro wry
ans2 lhm mbi	lhm mbi
ohx wda ygj ans1 lhm dyq wda	lhm
ans3 hvu pgd tpy	hvu pgd tpy
mbi hlq dyq mbi ans2 hir lgh nvc hlq tpy tao	hir lgh
icy irg rlt ans1 pna dyz fro kxd mbi	pna
rlt ans1 rlt mbi	rlt
ygj dyz god god ans2 nms dyq hcx god	nms dyq
pgd tao ygj tpy ans2 dyq bhp hir kxd ohx	dyq bhp
tao lgh rlt opa ans1 ykm hvu hcx hlq rlt	ykm
ans3 lhm nvc opa ykm dyq	lhm nvc opa
ans1 ykm pgd	ykm
fro hvu rlt ans2 ykm icy lgh opa	ykm icy
ygj ans1 opa fro rlt	opa
hvu hlq ans3 hir kxd ohx bhp nms	hir kxd ohx
pgd ans3 rfm irg rlt	rfm irg rlt
ans2 dyz dyz ygj	dyz dyz
lhm ans1 lhm dyq	lhm
rfm mbi ans1 tao pgd mbi	tao
dyq pna irg opa ans2 dyz kxd icy pna ohx ykm	dyz kxd
rfm opa hir ans1 nvc fro	nvc
pna lhm rfm ans2 pgd tao rlt pgd tpy	pgd tao
ygj god hvu hvu ans2 ygj hvu dyq	ygj hvu
tpy ohx mbi ygj ans1 hvu	hvu
ygj hlq pna ans3 rfm god tao hir	rfm god tao
ans2 god kxd hlq dyz tpy	god kxd
mbi ans1 pna fro pgd nms hcx	pna
ans3 lhm ykm lhm tao	lhm ykm lhm
tao lqx lqx dyz ans3 nvc dyz ykm ykm irg ykm	nvc dyz ykm
tpy dyq bhp nms ans2 wry lgh	wry lgh
rfm opa hvu hvu ans2 kxd lhm nms dyz tpy irg	kxd lhm
ans2 ohx dyz hvu	ohx dyz
hvu ans1 dyq lqx icy rlt	dyq
fro lgh hcx lqx ans1 hcx bhp hvu pna	hcx
wda dyq ykm bhp ans3 lqx nms mbi dyz	lqx nms mbi
dyz ans1 fro	fro
ans3 ykm tao hlq	ykm tao hlq
hlq opa hir ohx ans2 ohx ohx pna pna fro	ohx ohx
hcx ans3 hvu irg irg	hvu irg irg
bhp fro ans1 nms icy fro god	nms
lgh ans2 nms opa hir wda dyq	nms opa
nms rlt hvu ans3 kxd dyq hcx	kxd dyq hcx
dyz ans3 god hlq lhm pgd nvc	god hlq lhm
ans2 hir hvu	hir hvu
icy tao god ans2 fro irg ygj	fro irg
lhm ans2 nms ykm bhp god mbi lgh	nms ykm
hir hir fro ans2 opa tao bhp wry	opa tao
irg wda nvc ans3 fro hvu irg lqx dyz	fro hvu irg
kxd hvu icy ans1 pgd	pgd
hvu mbi wda ans2 opa lhm	opa lhm
ohx tpy lqx irg ans3 opa mbi hir opa hcx	opa mbi hir
ohx pna ykm nvc ans1 tao mbi lgh lqx nms	tao
nvc bhp ans2 rfm god rfm dyz ygj dyq	rfm god
hcx ans3 hcx dyz rlt tao	hcx dyz rlt
kxd tpy wry ans3 ohx hvu dyq hir icy icy lqx	ohx hvu dyq
nms ykm pgd ans1 tao wda ohx dyz kxd	tao
ohx hlq pna ans1 rfm ygj tpy	rfm
nvc hcx ans3 ygj rlt hcx irg wry pgd icy	ygj rlt hcx
nms ygj ans1 fro lgh god	fro
tpy icy dyq ohx ans1 dyq dyq irg	dyq
fro bhp ans2 wda lhm nvc icy	wda lhm
hir wry pgd ans1 lqx opa	lqx
hir pna ans2 tpy opa ygj tao	tpy opa
lhm rlt ans1 ohx	ohx
ans2 irg nvc pgd god tpy ygj	irg nvc
ans1 hcx wda	hcx
icy lgh bhp dyz ans1 rlt pna rlt	rlt
lgh ans2 kxd ygj irg irg god	kxd ygj
lhm irg ans1 rfm hir fro nvc lgh	rfm
pna pna tpy hvu ans1 tao hvu nms tao lqx	tao
pna bhp ans3 ohx dyz nvc wda icy	ohx dyz nvc
irg ans2 nvc nms tao	nvc nms
lgh hcx mbi hir ans2 dyz dyz hcx wry hcx	dyz dyz
nms ans2 lhm wry lgh pgd dyz	lhm wry
dyz ans2 ygj hlq opa	ygj hlq
kxd ans2 nvc wda irg hcx	nvc wda
lqx ans2 hir hvu wry tao kxd bhp	hir hvu
dyq ygj mbi ans3 tpy dyq icy irg	tpy dyq icy
ans1 dyz dyz lhm irg lgh	dyz
mbi pna ans3 mbi wry dyq lhm hvu god	mbi wry dyq
rfm ans1 mbi nms bhp tpy	mbi
ans3 rfm dyz tao	rfm dyz tao
ans3 icy lqx nvc tpy nvc kxd	icy lqx nvc
tao ans2 bhp tao nvc icy	bhp tao
hvu tao ans1 kxd nvc irg tpy	kxd
pgd ans2 hcx rlt	hcx rlt
icy fro ygj irg ans3 bhp dyq ohx nms nms wda	bhp dyq ohx
ans3 ygj pgd mbi	ygj pgd mbi
dyq fro ans3 pna mbi hir ykm	pna mbi hir
kxd rlt lhm ans1 icy opa dyz nms	icy
lgh opa wry tpy ans2 lgh pgd bhp	lgh pgd
nms dyq lhm lgh ans3 dyz rlt bhp hlq wry rfm god	dyz rlt bhp
lqx ans3 bhp wry opa tao mbi	bhp wry opa
wry pgd hir lqx ans1 ygj hvu god	ygj
nvc hvu hvu pgd ans1 rfm nms rfm pna	rfm
pna ans3 lgh kxd nms wda	lgh kxd nms
ans3 fro irg lqx tpy nms icy bhp	fro irg lqx
dyq wry bhp hlq ans1 god icy lhm	god
ans1 rfm hcx	rfm
wda dyq hcx wry ans2 lgh hir ohx lqx lhm	lgh hir
ans2 hir nms lhm tpy	hir nms
ans3 irg nms pgd mbi ohx tpy	irg nms pgd
opa nvc tao ans2 pna hlq wda god opa kxd	pna hlq
ans2 pna lhm tpy hcx	pna lhm
ans3 icy ohx icy nvc tpy ygj lgh	icy ohx icy
nms wry bhp ans3 lhm rfm pna kxd dyq lhm	lhm rfm pna
hir fro ans3 lhm icy ygj opa irg mbi lhm	lhm icy ygj
hvu nvc lqx pna ans2 pgd irg tao lqx	pgd irg
fro ans3 ykm lhm wda tao hlq lhm	ykm lhm wda
ans1 mbi nms hcx	mbi
bhp wda dyz ans3 rfm ohx rfm opa god fro tpy	rfm ohx rfm
rfm opa ygj ans1 wry pgd nvc hlq mbi	wry
ans2 lqx lgh rfm	lqx lgh
ygj dyq nvc lhm ans2 pgd wry hcx hvu dyz pgd	pgd wry
lqx nvc ans3 rfm ykm opa mbi dyz rfm	rfm ykm opa
rlt ans1 wda irg hlq opa	wda
ohx dyq dyz ans3 kxd bhp lqx	kxd bhp lqx
wry ans1 irg hvu fro	irg
tpy hcx ygj pna ans1 god ykm kxd pna lhm	god
fro rfm nvc hcx ans2 tpy rlt rfm nms nvc nvc	tpy rlt
rfm rlt dyq hvu ans1 rfm lhm dyq	rfm
mbi tpy mbi ans3 mbi opa icy tpy mbi dyq	mbi opa icy
hcx wry nvc wda ans2 irg hcx god hcx hvu tpy	irg hcx
opa rfm ans3 ygj fro tpy nms rfm tpy wda	ygj fro tpy
dyq hvu ans2 lqx fro bhp	lqx fro
ygj ygj ohx ans2 bhp bhp fro	bhp bhp
pgd ohx hvu rlt ans3 wda rlt hcx fro rlt kxd pgd	wda rlt hcx
ans1 pgd wry bhp	pgd
ans1 lqx	lqx
hcx ans2 nms ykm opa icy god nvc	nms ykm
ans3 ygj mbi god hcx	ygj mbi god
opa ans2 kxd nms rfm kxd kxd bhp	kxd nms
ans1 icy hvu	icy
bhp dyq fro hcx ans1 lqx icy rlt nvc	lqx
nvc wda pna ans2 hir pgd lqx rlt pna kxd	hir pgd
ohx dyz lhm dyq ans3 wda dyq mbi ykm	wda dyq mbi
opa nvc wry ans2 dyq dyq hlq opa	dyq dyq
lhm nms ans1 mbi lhm ykm tpy wda	mbi
ykm tpy lqx wry ans2 dyz pgd	dyz pgd
lhm ans1 hvu fro	hvu
tao wda ans1 lhm hvu icy ohx fro	lhm
god ans1 ygj	ygj
ans2 ohx icy nvc hcx hir rfm	ohx icy
hcx pna wda rlt ans1 lhm hcx hir bhp	lhm
hlq lhm ygj opa ans3 wry god tpy tpy hlq tpy lgh	wry god tpy
dyz ygj ans1 rfm pna tpy mbi	rfm
nvc kxd icy ans2 opa ohx mbi pna hvu	opa ohx
mbi hir hcx kxd ans3 mbi fro nvc nms lhm bhp	mbi fro nvc
ohx nvc mbi mbi ans2 god ohx ohx ykm	god ohx
wry rlt opa ans1 lgh lgh	lgh
hir ans2 lhm wda	lhm wda
wry lqx ans1 nms tao rlt	nms
ohx fro ans3 wda rlt pna irg wry hir god	wda rlt pna
ygj opa god ans1 lhm lgh hir icy	lhm
dyq ans3 opa hvu opa	opa hvu opa
ans1 kxd kxd	kxd
ykm ans3 fro opa hvu lqx bhp ohx wry	fro opa hvu
ans1 wry	wry
mbi ans2 god nms	god nms
pna lhm ans2 hvu dyz	hvu dyz
ans1 nms	nms
opa ans3 rlt tao ygj ykm tao	rlt tao ygj
ans3 kxd hvu rlt nms	kxd hvu rlt
ohx ans3 pna lgh pna lgh nms	pna lgh pna
ygj ans1 pna dyq bhp	pna
wry god tpy ans2 hcx pna	hcx pna
mbi ans3 hir lqx rlt nms dyz ykm icy	hir lqx rlt
hir lhm ohx ans2 dyz wda kxd	dyz wda
ans2 fro tao	fro tao
rlt fro ans2 hvu rfm wda	hvu rfm
ohx ans3 nvc bhp kxd ykm wda lhm	nvc bhp kxd
lgh ans1 god wry	god
ans2 hvu irg tao	hvu irg
hir ans1 wry wry lgh ygj kxd	wry
mbi ans1 ykm dyq wry	ykm
rfm hir ans3 icy rlt hlq dyz opa	icy rlt hlq
wry ykm ans1 bhp irg hcx wry ykm	bhp
opa ans2 hir hvu	hir hvu
bhp pna ans2 ykm mbi hir hcx	ykm mbi
ans1 lgh	lgh
ohx opa irg ans3 kxd icy god lqx	kxd icy god
rfm ans1 hir nvc pgd bhp hir	hir
pgd mbi fro bhp ans1 irg	irg
dyq ans2 wda hir irg fro	wda hir
tao nvc ans2 lgh icy opa pna	lgh icy
mbi ans3 dyq wry hcx dyq tao dyz	dyq wry hcx
ans1 wry ohx rlt	wry
lqx tpy ans3 bhp wry fro irg dyq	bhp wry fro
lqx ans3 nvc dyq nvc	nvc dyq nvc
ans2 ygj irg hir hir ykm wry	ygj irg
pgd ykm bhp dyz ans3 rlt dyq icy lqx nms ohx kxd	rlt dyq icy
pgd lhm ans1 lqx icy kxd bhp	lqx
opa ygj icy ygj ans1 dyq god tpy	dyq
lgh ans2 hcx irg opa mbi hir	hcx irg
lhm ans2 dyq pna god	dyq pna
wry wry ans3 wry kxd hvu	wry kxd hvu
ans1 opa rfm bhp rfm	opa
hcx rfm nvc nvc ans1 lhm wda nms	lhm
nvc dyq wry dyz ans3 ygj hcx nvc dyq nvc	ygj hcx nvc
god hvu dyq ans3 hvu hir lqx mbi tpy wry	hvu hir lqx
hcx nms pna ans2 pna opa rlt	pna opa
rlt wda rlt ans1 ohx icy	ohx
wda fro ans1 tpy nms	tpy
pna lgh ans2 nms bhp hvu opa lhm	nms bhp
ohx god ans1 mbi	mbi
hcx nms ans3 ykm ohx icy	ykm ohx icy
icy wry wda lhm ans1 nms hir dyq pgd	nms
fro ans1 god bhp wda fro	god
lqx ygj ans3 pgd hvu lhm hir	pgd hvu lhm
ans3 irg ohx irg dyq	irg ohx irg
opa opa mbi ans1 irg lhm	irg
tpy rfm kxd ans1 pgd ykm tpy	pgd
ans3 wda lgh rfm wda lqx icy	wda lgh rfm
god ans3 fro fro lqx	fro fro lqx
kxd lgh tpy hvu ans3 opa opa icy fro lhm kxd bhp	opa opa icy
ans2 rfm lgh wda hlq rlt pgd	rfm lgh
mbi dyz ohx rfm ans1 kxd	kxd
hlq wry pgd irg ans1 tao kxd dyq	tao
ans3 lhm pna fro	lhm pna fro
hir ans2 lqx nms wry dyz wry hvu	lqx nms
god dyq ans3 kxd god rlt	kxd god rlt
rlt pgd ygj lqx ans3 hlq hcx lqx god lhm opa hvu	hlq hcx lqx
irg ans3 rfm irg irg god pna ohx	rfm irg irg
ans3 hlq irg fro	hlq irg fro
rlt opa lgh nvc ans2 ohx hcx tao mbi	ohx hcx
nvc ans2 kxd rfm god lqx hir	kxd rfm
ans3 mbi wda nvc irg	mbi wda nvc
rfm hcx ans1 dyq mbi rfm ykm lhm	dyq
hir rfm lgh ans3 mbi tpy pgd god lhm hir god	mbi tpy pgd
fro icy fro ans1 hvu	hvu
tao tao lqx ans2 nms hir tao lhm hlq	nms hir
wry hir kxd ans2 hir rlt lgh	hir rlt
irg opa tpy hvu ans1 pna hvu irg tpy	pna
lqx ans1 ykm dyz	ykm
pgd ohx opa ans1 rlt bhp	rlt
fro ans1 irg hlq	irg
rfm lgh rfm ans2 rfm rlt irg	rfm rlt
hvu dyz ygj hcx ans2 rfm god hlq ygj icy bhp	rfm god
kxd ans3 mbi ykm opa nvc tao	mbi ykm opa
ans3 irg bhp fro hvu lhm kxd	irg bhp fro
pna ans3 tao wry nms opa hir rfm hvu	tao wry nms
rfm ans2 tpy lqx lgh lhm	tpy lqx
ans2 fro pna pna	fro pna
ans1 bhp hvu hir hcx	bhp
hvu ans3 ykm mbi lhm ygj	ykm mbi lhm
hir fro opa dyq ans1 fro	fro
ans1 rfm tao hlq mbi	rfm
ykm dyq ans2 rlt nvc bhp	rlt nvc
lgh ans3 icy lhm dyq	icy lhm dyq
irg hir lhm ans2 dyz pna	dyz pna
icy hlq bhp ans2 dyq wry nms rlt	dyq wry
rlt dyz ygj ans1 hir hlq	hir
pgd wda ans2 hlq dyz	hlq dyz
bhp wry wda ans3 nvc nms rlt opa rlt	nvc nms rlt
rfm tpy ans2 nms pgd tpy wda irg wda	nms pgd
hcx nvc ans1 tao opa rfm ygj dyq	tao
dyz rfm wda ans2 bhp irg	bhp irg
tpy ohx ans3 nms opa hcx god god hcx pgd	nms opa hcx
lhm mbi ans2 opa fro nms tpy pgd lgh	opa fro
ans2 tao kxd hcx tao	tao kxd
nms ans1 lhm tao wry	lhm
ans3 fro wry hir icy bhp pna wda	fro wry hir
tao rfm tao hir ans3 rlt wry ykm wry ohx ygj	rlt wry ykm
ans2 icy nvc tao kxd	icy nvc
dyz nvc ohx ans2 irg ygj hir	irg ygj
icy fro rlt ans1 lgh tao pgd	lgh
god tpy hvu ygj ans2 ykm nvc nvc pna hlq nvc	ykm nvc
nms lgh wda ans2 irg hlq hir	irg hlq
dyq nvc rfm kxd ans2 bhp tao	bhp tao
hir hcx ans2 irg wda	irg wda
hlq ans2 dyz ohx	dyz ohx
fro ohx ygj bhp ans1 lgh rlt pgd	lgh
ans2 tao hcx fro hcx wda	tao hcx
ans1 dyq pna bhp fro tpy	dyq
wry pna dyq ans3 rfm tpy wry mbi mbi hlq	rfm tpy wry
ans3 lqx mbi bhp tpy	lqx mbi bhp
hvu god ans1 lhm kxd rlt tao nvc	lhm
dyq ygj ans1 lhm rlt god	lhm
ans1 hir	hir
lhm wda dyz hcx ans2 dyq rfm icy irg dyq	dyq rfm
hcx wry nvc rlt ans1 dyq	dyq
hvu ans3 nvc hlq nms icy ykm pgd rfm	nvc hlq nms
irg tao ans1 hcx wda hvu wda opa	hcx
opa dyq tao ans1 kxd	kxd
kxd opa ans3 opa bhp pgd rfm rlt icy	opa bhp pgd
bhp kxd pgd ans3 dyz tpy dyz hcx lqx hvu	dyz tpy dyz
ans2 pgd lqx	pgd lqx
hcx lqx hlq rfm ans3 ygj bhp lgh hcx	ygj bhp lgh
mbi wry ans2 hvu opa ygj nvc	hvu opa
lhm ans2 wda lqx rlt tpy	wda lqx
dyq ans2 kxd god	kxd god
ygj irg tao fro ans2 lqx ohx	lqx ohx
kxd fro ans2 nvc irg kxd pna ygj	nvc irg
ygj rlt ans1 pgd	pgd
ykm nms pna dyz ans2 rfm pgd tpy	rfm pgd
tao wda god nms ans2 nvc rfm hcx wry	nvc rfm
god nms wry ohx ans3 lhm lqx rfm hlq icy ohx pgd	lhm lqx rfm
pgd ans1 tpy lhm dyz	tpy
lgh hlq ans3 wda hvu lgh tpy lgh wda	wda hvu lgh
rlt kxd nvc ans1 hir hir	hir
ans3 hcx hvu pgd nvc rlt pna	hcx hvu pgd
ans3 wda wry hcx lqx pna pna hcx	wda wry hcx
mbi hir ygj ans3 hir hir hir tpy hlq hir nms	hir hir hir
rlt lgh rlt ans2 lqx dyq tpy tao	lqx dyq
wda lhm hcx ans1 ohx	ohx
nvc lqx hcx kxd ans1 bhp rlt ygj wda hvu	bhp
hcx mbi irg ohx ans3 ygj lqx nms lqx ohx lgh	ygj lqx nms
dyq nvc lqx icy ans1 fro hvu rlt pgd	fro
ohx ans2 wda mbi	wda mbi
ykm hcx ans1 irg hlq	irg
wda ans1 wry hvu	wry
wry ohx ans3 rlt irg irg hvu hlq ygj	rlt irg irg
irg pgd ans2 dyz god lqx	dyz god
bhp lqx opa ans2 icy tpy pgd	icy tpy
tao lqx pgd ykm ans3 dyz dyq rlt tao wry hlq kxd	dyz dyq rlt
ans1 dyq hvu ygj tao opa	dyq
hlq ans2 lhm ohx rlt lgh wry pgd	lhm ohx
wry opa lqx lqx ans2 opa tao opa hvu ygj icy	opa tao
lgh icy ans3 opa icy god wry	opa icy god
dyz ans3 pna dyz ykm lqx	pna dyz ykm
rlt ohx tpy hcx ans3 rfm ygj ykm opa god	rfm ygj ykm
kxd wry lgh tao ans1 mbi fro pgd lgh mbi	mbi
hvu pgd ygj hir ans3 hir icy ygj mbi wda nms rfm	hir icy ygj
god wry lgh god ans2 hcx rfm icy hcx hcx wry	hcx rfm
hir ans3 kxd rlt opa	kxd rlt opa
tao fro opa hlq ans2 dyz rlt lhm god fro	dyz rlt
tpy ans1 ykm hcx rlt fro	ykm
lhm ohx kxd rlt ans3 pna pgd irg	pna pgd irg
irg hvu ans2 pgd lhm bhp nvc	pgd lhm
hvu ykm ans3 hir tpy hcx wry rfm	hir tpy hcx
hlq icy tao ykm ans3 wda dyz hlq pgd nms ykm wry	wda dyz hlq
opa dyq tpy ans1 god pna tao ykm	god
icy ans3 lgh ygj fro lhm lqx	lgh ygj fro
rlt nvc ans3 hir lgh wry	hir lgh wry
dyq nvc god ans1 dyz tpy pgd rlt	dyz
tpy nms ans2 pna tpy god hlq bhp	pna tpy
bhp ans2 nms mbi ohx dyz pgd nvc	nms mbi
ykm icy ans1 tpy	tpy
ans2 ygj pna hcx icy pgd	ygj pna
irg pgd ans1 opa hlq wda wry kxd	opa
ans3 irg god wry god hir hir rfm	irg god wry
mbi tao fro icy ans3 tao ygj tao	tao ygj tao
icy ans1 hvu	hvu
hcx nvc ans2 wda rfm nms rfm	wda rfm
ans3 hir ykm hvu wry wda nvc bhp	hir ykm hvu
ans3 pna ykm dyz	pna ykm dyz
ans1 fro wda bhp wda mbi	fro
ans2 wda rlt nvc nms ygj bhp	wda rlt
pna rlt ans3 pna nvc god god	pna nvc god
ykm wry ans1 mbi wry	mbi
mbi ans3 opa bhp lhm	opa bhp lhm
wda tpy ans3 tao ygj ygj wry ohx pgd icy	tao ygj ygj
lqx ans2 ykm wry rlt	ykm wry
wry ykm lhm hcx ans2 hcx fro	hcx fro
hir pna kxd ans1 wda mbi lqx dyz tpy	wda
wda hlq ans3 tpy wda dyz tao opa	tpy wda dyz
ygj lhm lgh mbi ans1 icy ykm	icy
mbi pgd ans2 fro wry hlq hlq dyz	fro wry
ans2 rlt god opa icy fro tao	rlt god
pna ygj fro ans3 bhp irg irg	bhp irg irg
fro ans2 hcx tao	hcx tao
lgh bhp ans3 hlq tao hir pgd ygj lhm	hlq tao hir
ans1 lgh lgh pna hvu	lgh
tao god irg ans1 tao nms	tao
mbi tpy hcx nms ans2 hvu hvu irg tao ygj hcx	hvu hvu
ans1 dyz lgh ygj rlt pgd	dyz
hir ans2 nms ygj fro ohx icy opa	nms ygj
god icy ans2 rfm nvc god	rfm nvc
lgh tpy ans3 wda fro ykm dyq	wda fro ykm
tpy hvu nvc ans3 tao fro lgh hlq hlq	tao fro lgh
ans3 lqx god hvu bhp pgd hvu ohx	lqx god hvu
god tpy ans3 nms mbi nvc god hvu	nms mbi nvc
rfm wda rfm ans3 wry ohx god hcx rlt ygj wda	wry ohx god
wda rlt tpy hlq ans1 ykm pgd bhp opa lgh	ykm
nms hir ans2 hlq hlq rfm lqx lqx dyq	hlq hlq
wda ans2 nvc ohx wry kxd rfm hlq	nvc ohx
mbi god ans1 tpy fro tao rlt	tpy
ykm dyz fro fro ans3 hlq god opa opa	hlq god opa
irg pna nvc rfm ans1 lgh bhp pna hcx	lgh
ans1 kxd mbi icy hcx pna	kxd
mbi pna ans3 hir wda tao	hir wda tao
rlt rfm ygj ans1 pna lhm	pna
hvu ans3 hlq lhm icy god lgh hir god	hlq lhm icy
wda mbi kxd bhp ans3 mbi hlq wry hir	mbi hlq wry
hcx ans3 nms ohx rfm ohx ohx bhp	nms ohx rfm
god irg ans2 god ykm bhp god	god ykm
wda lgh ans2 opa lqx nms	opa lqx
ans2 lgh lgh fro tao kxd ohx	lgh lgh
nvc ans1 fro pgd dyq pgd	fro
nms kxd wry fro ans1 kxd tao ygj	kxd
ans1 tao hir	tao
tpy tpy pgd tpy ans3 hir nms lqx ohx god	hir nms lqx
dyq lqx ykm god ans2 icy mbi lhm god	icy mbi
tpy lqx ans3 hir nvc icy rlt lgh	hir nvc icy
ans2 rfm rfm kxd	rfm rfm
rlt ohx rlt tao ans1 icy tao lhm nms	icy
hir ans2 ohx pgd opa rlt	ohx pgd
ykm ans2 dyz fro rlt god pgd kxd	dyz fro
hvu irg ans2 lqx god lqx god	lqx god
lgh ans3 ygj opa tao	ygj opa tao
ans2 bhp god	bhp god
tpy nms wda nms ans2 god hlq opa	god hlq
tpy nvc lgh ans2 ygj god pna	ygj god
hvu lqx ans2 kxd dyq nms	kxd dyq
icy ans2 icy wry	icy wry
pna god ans2 hlq mbi tpy mbi pgd nvc	hlq mbi
lgh rlt nms nvc ans1 icy hlq hir hcx	icy
lhm dyz ans2 wda fro hlq tao	wda fro
icy ans3 pna tpy opa nvc ohx hcx dyz	pna tpy opa
pgd ans2 hlq fro mbi hir lhm	hlq fro
opa ans1 bhp hcx tpy lgh ygj	bhp
lgh rlt lhm ygj ans1 pgd	pgd
fro pna god rfm ans3 dyz dyq lhm	dyz dyq lhm
dyq lgh ans3 nms lqx pgd lgh nms kxd ykm	nms lqx pgd
wda god ans1 wry dyz	wry
hvu ans2 pgd mbi ykm pgd hvu	pgd mbi
lgh ans2 lgh lgh hvu irg	lgh lgh
bhp ygj ans3 tao wda hir lhm	tao wda hir
tpy irg nvc ans3 wry dyz lhm	wry dyz lhm
god dyq tao ans2 mbi ykm wda	mbi ykm
icy lgh dyq ans1 ykm pgd hlq	ykm
nms ans3 pna ohx tao ykm dyq hvu	pna ohx tao
ans2 irg hir	irg hir
ans1 opa tpy	opa
kxd hlq lhm irg ans3 bhp hlq kxd	bhp hlq kxd
lgh hvu ans1 hvu wry dyq bhp	hvu
ans2 lgh rlt hcx hcx wda	lgh rlt
hir pgd irg bhp ans1 hlq lgh hlq god rlt	hlq
ykm wda hvu dyq ans2 lqx dyz god wry	lqx dyz
pgd ans3 mbi lhm irg irg	mbi lhm irg
rlt ans3 ygj hir hir tpy hlq dyq ohx	ygj hir hir
hcx tpy nms ans2 nms dyq pgd lgh	nms dyq
mbi hcx rfm lgh ans2 tpy rfm hir icy fro tao	tpy rfm
ans3 ohx ygj bhp	ohx ygj bhp
nvc opa wry hir ans3 lgh opa nms nms	lgh opa nms
ykm god lhm ykm ans1 lgh hlq ohx	lgh
lqx ygj tpy ans3 hlq hir dyq	hlq hir dyq
god pgd ans2 irg kxd rlt opa	irg kxd
rlt dyq ans1 lhm nvc hvu fro fro	lhm
fro ans3 ohx icy wda	ohx icy wda
opa rfm rlt ans3 nvc lhm rlt hlq	nvc lhm rlt
tao lqx hir ans3 god irg lhm god	god irg lhm
god mbi ans1 pna fro	pna
pgd opa hcx ygj ans3 wda lgh god bhp lhm	wda lgh god
icy tao lqx mbi ans2 pgd pgd bhp dyz ygj	pgd pgd
fro rlt lgh hlq ans1 tpy lqx	tpy
hir rfm hlq ans3 wda wry pgd ygj wry god	wda wry pgd
ans3 tpy dyq wda tao bhp	tpy dyq wda
ans3 opa mbi tao hcx nms ohx kxd	opa mbi tao
ans3 tao lgh kxd hvu	tao lgh kxd
fro lqx rlt hir ans1 ohx hlq	ohx
tao ans2 lgh wda nvc bhp	lgh wda
hlq pgd lgh ans3 tao mbi rfm	tao mbi rfm
ans2 wda bhp	wda bhp
lqx opa ans3 hlq dyz pgd tpy hcx wry	hlq dyz pgd
ygj lqx opa ans2 rfm fro dyz irg pna ykm	rfm fro
ygj pgd ans3 kxd dyz kxd fro pgd ohx lqx	kxd dyz kxd
kxd ans3 god bhp icy kxd	god bhp icy
tpy lgh ans3 hir ykm wry	hir ykm wry
rfm hcx ohx kxd ans2 ohx wda tpy hlq	ohx wda
fro nvc fro wda ans1 ykm hvu tpy wda wry	ykm
pna hvu ans2 ohx lgh bhp	ohx lgh
rlt bhp pna tao ans2 hlq mbi kxd	hlq mbi
pgd lgh wry fro ans3 god lgh rfm	god lgh rfm
pgd lgh ohx ans1 hcx ohx wry	hcx
lhm ohx ans3 pna rlt wda	pna rlt wda
bhp pgd lhm ans2 god lqx	god lqx
ans1 pna bhp	pna
tpy rfm ans2 hcx hir god nvc hir hcx	hcx hir
hir ans2 rlt god wry ygj	rlt god
rlt lgh ygj god ans3 tao dyq hir ygj	tao dyq hir
dyz ans3 ohx wda kxd dyq	ohx wda kxd
nvc nms icy icy ans1 ykm	ykm
ans2 god tao lgh	god tao
bhp dyq ans1 nvc mbi dyq pgd hlq	nvc
lhm ans3 hvu tpy rlt hlq	hvu tpy rlt
wda ygj wry ans3 hcx pna rfm mbi	hcx pna rfm
tpy ans1 lhm lgh lhm nvc bhp	lhm
dyq opa nms ans3 nvc rlt opa tpy	nvc rlt opa
lhm ans2 ygj irg ohx god god hlq	ygj irg
god god icy ans3 nvc fro lqx bhp ohx rfm	nvc fro lqx
tao nms ans2 lgh irg	lgh irg
pna tpy hir ans1 irg lhm god mbi god	irg
wda pgd ans1 bhp dyz ykm fro	bhp
lgh hlq ans2 dyz ygj	dyz ygj
icy ygj hvu tao ans1 icy	icy
ans2 wda irg bhp wda dyq bhp	wda irg
rfm wry ans3 tao ygj hcx hlq hlq opa hir	tao ygj hcx
lqx rfm lhm ans1 god wry	god
rfm tpy ykm ans2 ygj bhp	ygj bhp
rlt ans2 lhm dyz irg hir hlq	lhm dyz
ans2 god ykm irg	god ykm
dyz dyq ans3 ykm hir ykm lqx	ykm hir ykm
pgd dyz pgd kxd ans3 dyz lqx nvc hlq tpy	dyz lqx nvc
icy lhm ans3 wry bhp icy dyq tpy rfm	wry bhp icy
fro god lhm ans3 pna tpy rfm mbi	pna tpy rfm
hvu ans2 hvu lhm hcx bhp	hvu lhm
hvu hir ans3 rfm hcx tpy	rfm hcx tpy
hcx wda ans1 ohx nvc ykm dyq pgd	ohx
rlt ans2 hcx wda opa rfm wda opa	hcx wda
ygj nms nms irg ans2 dyq lgh kxd hir tao	dyq lgh
hir bhp nms ans2 hir dyz bhp	hir dyz
ans1 wda wry icy	wda
ohx dyz dyz ans3 rfm lgh fro	rfm lgh fro
kxd pgd god ans1 nvc irg god pgd	nvc
ohx ykm ans2 nvc wry nvc	nvc wry
ykm ans1 rlt dyq rlt	rlt
nvc ans3 dyq nms irg tao rfm god icy	dyq nms irg
tpy nms nvc tao ans2 tpy hlq dyz wry lqx ykm	tpy hlq
icy lqx mbi ans2 dyz ohx fro god	dyz ohx
wry ans1 rlt	rlt
god lgh lgh ans3 rlt kxd hvu ygj rlt hlq lqx	rlt kxd hvu
ygj ans2 nms wry tpy	nms wry
mbi ans3 hcx nvc god rlt	hcx nvc god
god ans2 nvc hvu lgh lqx ygj hvu	nvc hvu
tao lhm ans2 rlt mbi ohx ygj lhm	rlt mbi
ohx lhm mbi rfm ans2 nvc ygj	nvc ygj
ohx kxd hlq ans2 pna god god	pna god
nvc nms dyq ans3 ykm nvc kxd icy	ykm nvc kxd
ans3 hcx hcx wry pna wry lhm	hcx hcx wry
ygj ans1 ygj	ygj
ans3 mbi nms wda dyz dyq	mbi nms wda
lgh irg ans2 rfm lqx wry	rfm lqx
ans2 lgh hvu lqx	lgh hvu
ohx lgh pgd ohx ans3 hlq fro ygj bhp opa dyz	hlq fro ygj
ans1 dyq ykm kxd icy dyq	dyq
icy kxd ans1 opa nms hlq lqx wry	opa
pgd fro nms pgd ans2 wda kxd hir pgd	wda kxd
rlt ans1 wry hcx dyq	wry
ykm hir ans2 ykm lhm wry	ykm lhm
ans1 hcx lgh hvu bhp	hcx
hlq hir wda bhp ans2 kxd hir ygj	kxd hir
wda ans3 lqx hvu irg hvu	lqx hvu irg
dyq dyz hlq dyq ans1 hlq	hlq
ygj ohx hir kxd ans3 lgh rlt kxd tao	lgh rlt kxd
ans3 rlt tpy hcx irg	rlt tpy hcx
ans1 rfm icy hir tpy	rfm
nvc ans1 rlt wda fro hlq lqx	rlt
dyz dyz rlt bhp ans2 hir hcx dyz pna	hir hcx
tpy god ans1 bhp dyq opa	bhp
dyz ykm ans1 dyz hvu hcx	dyz
pna bhp ans1 wda rlt hvu pna dyq	wda
icy ykm tpy ohx ans3 pna dyq pna wda tpy lqx irg	pna dyq pna
bhp kxd hcx ans2 god lqx dyz tao hlq icy	god lqx
dyz ans1 tao	tao
hir bhp lhm ans3 irg tpy nms dyq wda	irg tpy nms
god lhm fro ans2 nvc tpy hir	nvc tpy
pgd pna ans3 hir rlt dyq irg lgh hcx	hir rlt dyq
wda kxd ans2 tao ygj lhm dyz opa	tao ygj
ans1 wda bhp rfm dyq nvc	wda
ygj dyq hvu ans3 bhp ygj lhm	bhp ygj lhm
ans3 icy fro dyz hlq hlq	icy fro dyz
nvc tao pna nms ans3 kxd wda opa rfm kxd irg	kxd wda opa
ans1 tao kxd fro	tao
nvc wda ans2 rlt hir fro mbi rfm	rlt hir
rfm god ohx irg ans3 lgh irg pna	lgh irg pna
ykm ans1 nvc lgh rlt kxd	nvc
ans1 hvu bhp	hvu
ohx ans1 pgd irg dyz	pgd
rfm pgd ans3 icy mbi hvu wda ygj lhm wda	icy mbi hvu
ygj hvu hvu wry ans3 ohx ykm dyq	ohx ykm dyq
ans3 rfm hir dyz wry ygj ykm	rfm hir dyz
kxd wry lhm ans3 ygj opa pna mbi lgh	ygj opa pna
fro ans3 god nvc mbi dyq ohx kxd icy	god nvc mbi
dyz lhm pna ans1 hcx dyz kxd tao nvc	hcx
tao rlt rlt lqx ans3 hvu wda lgh wda hcx tpy	hvu wda lgh
lhm ygj bhp ans2 wda fro	wda fro
hcx pna tao ans1 pna pgd	pna
irg dyz rfm tao ans1 rfm ohx mbi dyz	rfm
lhm ans1 hvu ygj ohx wda	hvu
ans3 irg ykm nvc lqx	irg ykm nvc
wry hcx tao ans3 hvu tpy fro pna nms fro	hvu tpy fro
ans2 pna hlq tao lgh ohx ygj	pna hlq
irg ans1 nvc	nvc
wry rlt ans1 rlt hvu dyz ohx hlq	rlt
ans2 opa fro	opa fro
lqx rfm ans3 hir nms icy fro hcx kxd	hir nms icy
nvc hir hvu ans3 nvc lgh nvc opa	nvc lgh nvc
nms ans2 dyq nvc	dyq nvc
hcx ans2 tao pgd hlq	tao pgd
god ans1 tao nms lgh	tao
hlq pna ans3 ygj nms pgd tpy	ygj nms pgd
ans1 wry icy bhp lgh	wry
lgh lqx rfm ykm ans2 ohx hir	ohx hir
ygj hir ans1 hvu nms tao nms nms	hvu
bhp fro wry wry ans1 hlq rlt nms	hlq
pna ans1 rlt wda dyz pna	rlt
tao wda hlq tao ans1 god rfm pgd	god
icy ans1 god ykm lgh	god
mbi ans1 hvu ykm irg icy lqx	hvu
lqx fro pna wda ans3 ykm ohx wry hir mbi	ykm ohx wry
bhp ans3 lhm ygj hvu hir dyz hcx dyq	lhm ygj hvu
dyz god pgd fro ans3 ykm hcx hvu	ykm hcx hvu
wry ygj ygj ans3 rlt ygj hir nms hlq	rlt ygj hir
tpy lhm hir ans2 god wry fro mbi	god wry
ygj lhm ans2 kxd hvu	kxd hvu
ans1 rlt nvc wda	rlt
rfm lgh ans2 mbi wda hcx god ykm	mbi wda
ans1 fro lgh	fro
lgh rfm opa tao ans1 hcx	hcx
hvu nms pgd ans2 dyz icy ohx nms	dyz icy
opa ans1 ygj bhp fro kxd	ygj
hir ans3 tpy pgd wda	tpy pgd wda
ygj ans1 hcx icy	hcx
lgh ans3 pna hcx tpy dyz	pna hcx tpy
dyq ohx tao rfm ans3 kxd nvc lqx tpy kxd	kxd nvc lqx
tao rlt hlq mbi ans1 rfm kxd god	rfm
tao mbi lqx dyz ans2 lgh wry	lgh wry
ans3 tao hcx pna lgh ykm opa tpy	tao hcx pna
tao fro dyq rlt ans1 wry	wry
fro fro ohx lhm ans3 icy dyz fro ykm ykm hvu	icy dyz fro
opa pgd hlq dyq ans3 opa lgh hcx	opa lgh hcx
hlq pgd hir ans1 wry	wry
wda rlt ans3 lgh tao pna	lgh tao pna
lgh pgd ans1 hir tpy	hir
hcx wry ans3 opa mbi tpy kxd wry	opa mbi tpy
nvc ans1 dyz wda	dyz
ans3 lhm bhp ykm hir wry wda	lhm bhp ykm
ygj ans1 ygj icy nms pna	ygj
kxd lqx dyq ans2 lqx bhp ohx ykm	lqx bhp
mbi pgd ygj ans3 lgh hvu bhp	lgh hvu bhp
ans2 hcx ygj dyq mbi pna ykm	hcx ygj
pgd mbi lqx nvc ans1 dyq kxd ykm	dyq
ans2 rfm ygj rfm	rfm ygj
ans3 dyq wry tao	dyq wry tao
pna ans3 wda wda ykm irg	wda wda ykm
wry hir ans3 ygj tpy nvc	ygj tpy nvc
ans1 nms	nms
hir kxd ans2 lgh tao	lgh tao
ans2 mbi nms rlt icy hir mbi	mbi nms
lhm nms pna ans2 nms pgd hir	nms pgd
ans3 nvc dyq rlt rlt	nvc dyq rlt
tao icy fro ans3 rfm lgh hvu wry bhp tao	rfm lgh hvu
fro opa ans2 wry lqx	wry lqx
hlq ans2 wda god	wda god
ygj ans2 bhp hcx wda kxd	bhp hcx
ans3 mbi rlt hvu rfm lqx rfm god	mbi rlt hvu
hvu opa ans1 lgh rfm tpy	lgh
hlq nvc ygj pgd ans3 god dyz hvu ykm lhm opa	god dyz hvu
icy kxd ans1 kxd ygj fro nvc	kxd
ans2 hlq lqx	hlq lqx
rlt bhp lqx ykm ans1 lqx ohx irg	lqx
ans2 kxd kxd pgd lgh ygj lhm	kxd kxd
dyq ans1 tao irg icy god	tao
nms god hir nms ans2 lgh tao ykm lhm wry	lgh tao
tpy tao ans1 god god irg pgd lqx	god
god hlq hvu hvu ans1 wda dyz rfm dyz dyz	wda
ans1 lhm pna	lhm
hir hvu nvc ans2 pna hir rfm wda rfm	pna hir
lqx wda ans3 hvu rfm rlt wda nvc lgh	hvu rfm rlt
bhp irg ans2 fro fro ohx	fro fro
irg ans2 irg ygj bhp nvc lhm wda	irg ygj
mbi ohx pna ygj ans2 opa god bhp nms hcx lqx	opa god
irg dyq god tpy ans3 tpy hlq ohx hvu pna	tpy hlq ohx
ans2 ohx rlt nms rlt nms	ohx rlt
tpy ans1 bhp bhp hir bhp tao	bhp
mbi hir tao lqx ans3 god hvu pna	god hvu pna
opa tao pna hcx ans3 bhp hlq icy god	bhp hlq icy
ans1 kxd dyq lqx	kxd
ans2 nvc tao nms pna kxd	nvc tao
ans3 nms irg opa ykm god dyz	nms irg opa
lgh hcx hir ans1 bhp pna icy	bhp
ans3 tpy mbi pna irg	tpy mbi pna
ans3 dyq hlq opa ygj	dyq hlq opa
ans2 mbi nms nms wry nvc	mbi nms
lgh wda wda nms ans1 ygj pgd	ygj
lqx dyz hvu wda ans3 lgh tao hvu ohx hlq	lgh tao hvu
ygj opa ans2 wda opa irg rlt hir	wda opa
ans1 nvc	nvc
rfm tao dyz lqx ans1 icy hvu tao ohx	icy
kxd fro hir ans3 rfm nms ygj	rfm nms ygj
hcx wda nvc ans3 tao dyz ygj hir bhp lqx god	tao dyz ygj
dyq wda ykm nms ans2 dyz god	dyz god
lgh rfm rfm ans3 rfm wda rfm nvc icy	rfm wda rfm
wry ans3 kxd lqx ykm tpy wda ykm ykm	kxd lqx ykm
nms nvc kxd icy ans3 nms hvu nvc irg	nms hvu nvc
tpy pgd ans2 kxd lhm hvu rfm lhm	kxd lhm
tao ans1 pna pgd	pna
ans1 lqx	lqx
tpy fro ans2 lqx tpy ykm lgh ykm	lqx tpy
ygj mbi tao ans3 wda icy hir	wda icy hir
wda rlt tao irg ans1 lqx lgh ohx pgd ygj	lqx
rlt god ans1 rfm hvu lhm tpy lhm	rfm
ans1 hir	hir
hlq ans3 kxd pgd hcx	kxd pgd hcx
lhm ans2 icy rlt hcx pgd ohx	icy rlt
pna pgd ygj ans1 pgd icy	pgd
tpy fro fro opa ans3 kxd irg fro	kxd irg fro
lgh lhm mbi ans1 rlt mbi	rlt
mbi mbi ans2 hcx tao irg mbi bhp	hcx tao
icy ans1 hir icy fro pna dyq	hir
hvu opa ans2 pgd wda nvc wda bhp opa	pgd wda
rlt dyq opa hir ans2 hvu wry ohx tao	hvu wry
hcx ygj ans1 hcx nvc	hcx
wry ohx ans3 hlq rfm mbi	hlq rfm mbi
dyq ans2 mbi bhp lqx	mbi bhp
ans1 lhm rfm rlt hcx tpy	lhm
hir tpy opa god ans2 icy bhp hlq	icy bhp
lgh god fro ans1 irg	irg
wda pgd icy lqx ans1 god pna	god
bhp ykm ans2 tao hvu	tao hvu
pgd ygj hvu irg ans3 nms ohx kxd lgh	nms ohx kxd
ans3 ygj dyz wda	ygj dyz wda
hvu tpy dyq ans1 god irg dyq tpy irg	god
lqx pna ans2 opa rlt	opa rlt
kxd tpy icy ans3 kxd kxd wry kxd hlq hir	kxd kxd wry
opa ans3 fro irg hvu hlq bhp tao	fro irg hvu
ans3 lgh ygj irg nvc tpy god kxd	lgh ygj irg
mbi ans1 ohx opa hvu	ohx
ykm tpy god ygj ans1 lhm	lhm
wda ygj rfm wry ans3 hvu pgd tao	hvu pgd tao
wda tpy ans3 pgd rfm god wry	pgd rfm god
lgh hvu hcx nms ans3 rfm wry lqx ykm ygj	rfm wry lqx
wda fro rlt hir ans3 irg wry hir tpy nvc	irg wry hir
nms tpy ans3 nms wda lhm hcx kxd wda rlt	nms wda lhm
pgd wry ans2 rlt mbi hvu wry nms	rlt mbi
ohx kxd ans1 lgh wry icy rfm dyq	lgh
ans3 ygj lhm wry	ygj lhm wry
fro tao ans1 wda hvu	wda
ans1 ygj hlq	ygj
rlt nms tao ygj ans3 tpy irg hcx lhm lgh	tpy irg hcx
ans3 ykm opa nms hlq	ykm opa nms
ygj nms hlq ans1 ygj lgh	ygj
lqx wda icy pgd ans3 tpy hlq dyq rfm lqx	tpy hlq dyq
rlt lgh ans2 rlt wry wry dyz	rlt wry
wda dyz ans1 icy lgh	icy
lhm tao ohx ans3 kxd tao opa pgd lgh	kxd tao opa
bhp bhp pna ans2 rfm fro tpy irg	rfm fro
rfm pna ans3 dyz wry ykm hvu tpy	dyz wry ykm
dyq hir lqx dyq ans3 pgd rlt tpy lgh pgd	pgd rlt tpy
dyq ykm mbi ans2 icy tao lhm fro	icy tao
fro hcx ans2 ygj lqx	ygj lqx
dyz ans2 god ykm nvc lhm wda nms	god ykm
ans3 hcx god rfm lqx nvc irg ygj	hcx god rfm
tpy icy dyz ans1 icy pgd mbi	icy
hvu ygj bhp ans2 hlq ohx ykm ygj wry ykm	hlq ohx
ykm icy ans2 ykm irg	ykm irg
ans2 tao hlq irg nms hcx ohx	tao hlq
ans1 hir rfm lqx pgd	hir
pgd ans2 rfm mbi	rfm mbi
lgh ans2 lgh hlq wry hcx	lgh hlq
ans3 tao god ygj pna	tao god ygj
tpy ans1 hvu	hvu
pna ans1 tao irg	tao
rlt wry ans3 tpy pna ohx lhm icy	tpy pna ohx
ans2 kxd pna lgh ohx hcx fro	kxd pna
lgh pgd tpy ans1 hvu dyq wda tpy	hvu
ohx ans2 kxd rlt pgd wry hir	kxd rlt
ans2 lgh hvu dyz ohx	lgh hvu
ykm ans2 rfm nvc opa icy lqx	rfm nvc
pgd bhp ans3 dyq hcx pgd nvc hvu	dyq hcx pgd
kxd ans1 pgd	pgd
lhm ans2 tpy ygj pna	tpy ygj
tao ans1 dyq	dyq
god pna nvc lgh ans2 nvc god hir irg	nvc god
pna ykm ans1 nvc pna lhm	nvc
ohx ans1 irg wda kxd	irg
kxd ans2 hir dyq	hir dyq
ans2 icy ygj ohx ohx mbi	icy ygj
lhm lqx fro lgh ans1 irg ohx lhm	irg
nms icy ans3 pna opa lhm hir irg fro opa	pna opa lhm
ans1 pgd pgd	pgd
lqx wry wry kxd ans3 tpy rfm pna ykm	tpy rfm pna
pna wda ans2 mbi tpy hcx hir hvu	mbi tpy
rfm ans3 kxd wry lqx	kxd wry lqx
rlt ans1 rlt lhm	rlt
ohx nvc hcx ans1 kxd rfm opa ohx nvc	kxd
lgh nms bhp kxd ans1 hir pna mbi	hir
bhp wry ans2 bhp pgd nvc ygj dyq kxd	bhp pgd
bhp lgh nvc ans1 god god	god
lqx opa ans1 god nvc rlt hvu rlt	god
ans2 dyz hcx bhp nvc nvc	dyz hcx
dyz bhp ans1 pgd nvc dyz icy	pgd
ans1 rfm	rfm
lgh ans2 ygj nms nms hir lhm	ygj nms
ohx ohx rfm tpy ans3 rfm lhm dyq	rfm lhm dyq
dyq opa ans1 irg icy icy opa	irg
pna lgh hir ans2 tpy irg icy tpy wda	tpy irg
tao fro hlq irg ans2 hir wda	hir wda
hlq nms ans1 rlt icy	rlt
kxd dyq hcx ans1 opa	opa
hcx dyz hlq rfm ans2 wda kxd nvc hcx tao	wda kxd
kxd ans2 tpy ohx	tpy ohx
pna ans3 nvc wda lgh ykm lgh bhp ykm	nvc wda lgh
fro hvu rfm lqx ans1 fro	fro
god rlt icy ans3 hvu hlq kxd rlt fro	hvu hlq kxd
ans3 nvc rfm icy ygj hvu lgh	nvc rfm icy
lhm wda dyz tpy ans3 wry hir bhp	wry hir bhp
kxd wda opa hlq ans2 bhp hir mbi	bhp hir
ykm bhp ans2 hir ykm rfm hcx nms lhm	hir ykm
kxd opa opa hlq ans2 rfm ohx dyq wry	rfm ohx
hir icy hlq lhm ans2 mbi nms lgh lhm kxd pgd	mbi nms
nms ans3 wry ygj irg rlt hlq dyz	wry ygj irg
icy opa mbi ykm ans1 icy dyq wry wda hvu	icy
nms hvu dyz ans3 lgh god kxd nvc nms ohx	lgh god kxd
hir dyz tpy ans1 rlt	rlt
hcx opa icy mbi ans3 rfm kxd icy pna pgd nvc lgh	rfm kxd icy
nvc nvc hlq ans2 rfm hlq rfm tpy mbi lgh	rfm hlq
icy wda lgh ans2 ykm wry ohx nvc	ykm wry
pgd ykm lgh ans3 ohx hlq mbi rlt opa god tpy	ohx hlq mbi
tao fro ans2 nvc wda opa hcx hlq	nvc wda
hcx opa ans1 hcx hlq ohx hlq	hcx
hir ans3 pna rlt hvu ygj pgd rfm	pna rlt hvu
rfm rfm opa rlt ans3 kxd dyq lqx ohx lgh rfm	kxd dyq lqx
ans3 mbi lqx kxd hvu lqx	mbi lqx kxd
lqx nms ans1 wry nvc rlt	wry
ans3 hlq icy irg hvu bhp bhp bhp	hlq icy irg
rlt dyz ans1 opa ygj	opa
ans2 rlt hvu wry wry nms	rlt hvu
rlt rfm hir ans1 god kxd pna tpy wda	god
tpy bhp ans2 pna pna kxd	pna pna
dyq lqx nvc ykm ans3 kxd tpy wda rfm rlt god opa	kxd tpy wda
ans3 tao ygj lhm	tao ygj lhm
opa fro tao ans1 hcx ykm kxd lgh	hcx
tao ans1 pna	pna
hlq icy ohx rfm ans2 hlq hcx hcx irg wry	hlq hcx
ohx pna dyz tao ans3 nvc wda icy pna	nvc wda icy
dyq ans1 kxd pna tao kxd ykm	kxd
rlt bhp ans2 pna dyq hcx wda	pna dyq
opa ans1 hlq	hlq
opa hlq god lhm ans2 kxd ohx god rlt dyz	kxd ohx
tpy rlt nms ans1 ygj dyz dyq tpy	ygj
ygj ans3 ykm fro hir rlt hir lgh lhm	ykm fro hir
pgd irg rlt ans3 irg ygj wda opa	irg ygj wda
hvu pgd irg dyz ans2 irg wry icy hcx	irg wry
hlq dyq ygj ans3 lhm mbi rfm wda hlq lqx pna	lhm mbi rfm
hvu ygj fro ans3 fro bhp lqx fro	fro bhp lqx
tpy hir fro hvu ans1 tao	tao
ans3 tpy tao wda hcx rlt	tpy tao wda
fro ans3 mbi bhp wry fro ykm rlt	mbi bhp wry
hcx ans1 tao lgh hcx pna	tao
mbi irg ans1 icy fro wda pna bhp	icy
opa tpy lhm wda ans2 opa rfm kxd kxd dyq pna	opa rfm
hir mbi hir pgd ans1 wda tpy rfm	wda
tpy nvc ohx god ans3 lgh hlq wry ohx ygj	lgh hlq wry
ans2 wda icy opa	wda icy
ohx tao ygj ans3 pgd kxd bhp mbi	pgd kxd bhp
ans3 lqx pgd dyq	lqx pgd dyq
opa pna hlq icy ans2 ygj bhp rlt pna kxd	ygj bhp
mbi rfm ans2 lgh wda bhp	lgh wda
ans3 tpy rlt nvc	tpy rlt nvc
nvc ans1 dyz pgd ygj	dyz
ans3 lhm lhm dyq tpy hlq	lhm lhm dyq
hlq ykm nvc ans1 god dyz dyq wry	god
ans3 ohx nvc ykm	ohx nvc ykm
ans3 dyq wry hir hir bhp	dyq wry hir
ykm wry mbi ans2 ygj lqx	ygj lqx
lhm god hlq ans1 hlq nms pgd ohx	hlq
wry ans3 wry nvc tao hvu	wry nvc tao
tao ans3 lhm fro wry hvu irg nms hvu	lhm fro wry
opa ans3 fro mbi lgh wry	fro mbi lgh
ans2 mbi hir hvu god rlt fro	mbi hir
lgh dyz hcx ans3 icy hlq ygj nvc dyq	icy hlq ygj
ohx lhm ans3 ohx hvu irg hlq	ohx hvu irg
tpy ans3 irg ygj god hcx tao dyq nms	irg ygj god
irg icy ans2 bhp mbi rlt god kxd	bhp mbi
ans2 wry tpy dyz ohx bhp lgh	wry tpy
ans2 ygj hir hlq ygj rfm	ygj hir
icy pna tao ans1 pgd wry nms	pgd
pgd ans3 fro nvc hvu pgd opa	fro nvc hvu
rlt ans2 lhm wda wry mbi rlt	lhm wda
ans3 ykm hvu lqx dyz	ykm hvu lqx
bhp hlq opa ans2 ohx pna fro rlt opa	ohx pna
ans3 dyz irg icy pgd lhm dyq god	dyz irg icy
hcx ans2 ohx mbi	ohx mbi
wry ans3 hir god ohx fro opa pna pna	hir god ohx
kxd wda dyz ans1 pna ygj	pna
ans1 dyz kxd	dyz
opa tpy ans1 pna	pna
ans2 opa tpy	opa tpy
bhp kxd wry lqx ans3 rlt rfm dyq ykm lhm nvc	rlt rfm dyq
hcx pgd hir hir ans2 wry god	wry god
ans1 tpy hcx wry	tpy
tao opa nvc nms ans1 hcx dyz nms	hcx
ans2 pgd tpy wda pna	pgd tpy
kxd mbi ans3 rlt tpy hlq hcx pna lgh	rlt tpy hlq
dyq opa ans3 bhp dyq pna fro	bhp dyq pna
lqx ans1 dyq ykm tpy bhp	dyq
kxd rfm lqx ygj ans1 wda	wda
pgd lqx ygj ans3 irg lhm tpy	irg lhm tpy
ans2 hir pna god opa	hir pna
wda nvc hcx lqx ans1 wda wry nvc	wda
rfm tao hvu nms ans2 icy rfm ykm	icy rfm
ans1 pgd	pgd
rlt opa ans1 dyq hvu tpy ohx fro	dyq
ans2 fro pgd	fro pgd
god god ans1 hir	hir
ans2 wry bhp	wry bhp
ohx hir rlt ans2 dyq fro opa hlq pgd	dyq fro
hvu wda ohx icy ans3 irg fro icy	irg fro icy
irg rlt dyq ans2 tao bhp tao tao	tao bhp
god ykm tao ans1 tpy pgd	tpy
ygj god hir nvc ans1 god lqx	god
icy wry ans1 opa lhm	opa
tao nvc rfm ans2 lqx wry hir pna	lqx wry
ans2 rfm opa mbi opa ygj	rfm opa
mbi ohx bhp ans3 kxd hvu hcx lgh god hvu wry	kxd hvu hcx
ans3 rfm hlq lhm lhm wda	rfm hlq lhm
bhp kxd fro tao ans1 lgh rfm wda	lgh
ans1 lgh wda hvu mbi dyz	lgh
lgh opa nvc opa ans2 ygj god	ygj god
hlq tpy ans3 god hvu lqx dyq kxd nvc	god hvu lqx
irg dyq ans2 lqx ygj nms tao dyz	lqx ygj
irg kxd nms dyq ans1 ygj ohx dyz dyz	ygj
lqx ans3 hlq hvu ykm ykm nms god	hlq hvu ykm
rfm nms rfm opa ans3 nms ykm hir mbi	nms ykm hir
ans3 pna icy nms	pna icy nms
rlt ohx ans1 dyz bhp nvc rfm	dyz
ans3 ohx rfm irg hcx god	ohx rfm irg
hir rfm ans3 hir mbi wry hir bhp rlt wry	hir mbi wry
bhp ans1 ygj fro hlq hir	ygj
ans1 ykm irg lgh hlq bhp	ykm
fro nms hcx fro ans3 dyq hvu pna rfm bhp	dyq hvu pna
hir ygj ans3 hir pna lhm	hir pna lhm
lhm tpy lqx ans3 ohx hlq lhm opa	ohx hlq lhm
lgh ans1 lqx ygj icy hlq	lqx
tao ans3 icy lhm tpy	icy lhm tpy
ohx ans2 bhp dyz kxd rfm	bhp dyz
bhp irg hlq ans3 hlq hcx wda wry dyz	hlq hcx wda
ans1 ohx hcx nvc kxd	ohx
wry rlt rlt hlq ans3 lgh god wry mbi ygj	lgh god wry
wda hir lgh lgh ans1 hvu nms	hvu
dyq irg irg irg ans2 ygj lgh ygj	ygj lgh
rlt lhm ygj wda ans1 tao lqx kxd	tao
lgh ans2 rlt tao wry mbi hlq	rlt tao
hvu mbi rfm ans3 nvc hvu ohx pgd rlt	nvc hvu ohx
lhm mbi icy ans1 wda	wda
tao ans2 rlt ygj hcx ohx lhm lhm	rlt ygj
lgh pna lqx ans1 god	god
wda ans1 mbi hcx lqx	mbi
hir lqx hvu ykm ans1 hlq	hlq
ans1 wry rlt bhp lqx	wry
bhp opa hvu ans1 pgd kxd	pgd
ykm lqx mbi wda ans1 rlt	rlt
ans2 kxd ykm tao	kxd ykm
ans1 lgh kxd hlq wda fro	lgh
icy ykm ohx ans3 pgd nms irg god irg pgd tpy	pgd nms irg
ohx lgh pna nvc ans1 icy tpy tao tpy tpy	icy
ans1 dyz dyq hvu opa opa	dyz
wda lqx icy ans2 lqx tpy lhm rfm lgh kxd	lqx tpy
ans2 ohx lqx nvc wda	ohx lqx
rlt mbi rfm ans1 fro pna rlt	fro
icy dyq pgd dyq ans1 kxd dyq	kxd
hvu wda lhm hlq ans1 nvc hcx opa pna ohx	nvc
rfm opa ans3 pgd lqx wda ohx nvc god	pgd lqx wda
dyz lgh fro mbi ans2 wry wry bhp dyq	wry wry
ans3 bhp hvu hir	bhp hvu hir
nvc pgd opa rfm ans2 lqx ygj pgd ohx	lqx ygj
ans1 dyz lgh opa	dyz
ygj kxd hir pgd ans2 dyq pna	dyq pna
hir opa ykm ans1 tpy pna mbi ohx icy	tpy
ykm ans1 hvu	hvu
kxd pgd dyq rfm ans1 hir lhm	hir
hir god icy ans2 ygj ykm hir wda mbi	ygj ykm
lhm ans1 opa rfm dyq ohx ohx	opa
bhp rlt ans1 dyq hlq	dyq
hlq ans1 lgh hvu hvu lgh bhp	lgh
dyz mbi wda ykm ans2 lhm lqx pgd ygj lhm	lhm lqx
ans3 irg ykm wda	irg ykm wda
ykm nvc hvu nms ans1 lqx	lqx
fro fro fro dyz ans3 dyz lqx pgd ohx god	dyz lqx pgd
ans3 hir tao opa dyz	hir tao opa
ohx ans3 nms rlt wda nms	nms rlt wda
ohx fro ans2 ykm hir	ykm hir
opa ans1 irg	irg
irg ans1 hir tao tpy kxd wry	hir
hvu dyq wda ykm ans1 hir ohx lgh mbi	hir
icy ohx ans1 wda pna kxd pna hir	wda
ans2 god ohx pna rfm lhm	god ohx
ans1 mbi opa pgd tao	mbi
lqx ans2 opa ygj	opa ygj
ans2 lqx dyz rfm irg ohx kxd	lqx dyz
wda ans1 ygj ygj pgd icy kxd	ygj
irg hir lgh hir ans3 dyq ohx hcx ykm god	dyq ohx hcx
hir hcx hcx ans2 dyq pna	dyq pna
ans3 dyq ohx wry dyz wda	dyq ohx wry
hir ans2 bhp kxd	bhp kxd
wry lqx nms ans1 ygj dyq	ygj
ans3 rfm kxd hcx ohx god	rfm kxd hcx
pna ans2 wda icy hlq wda	wda icy
ans1 fro ykm lqx mbi	fro
rlt hcx ans2 wry lgh	wry lgh
hcx wry ans2 god fro dyz	god fro
ans3 nms ykm irg wry lqx hlq	nms ykm irg
ans3 opa hvu god lqx lgh icy	opa hvu god
ans3 lhm rlt pna	lhm rlt pna
dyz icy ans2 mbi hcx wda kxd nms wry	mbi hcx
opa lqx kxd ans1 ygj god wda	ygj
opa hcx ans1 hvu rlt icy	hvu
ans2 tao opa nvc dyz hvu hir	tao opa
ans2 hvu hvu irg hir opa lqx	hvu hvu
ans3 rfm kxd tao	rfm kxd tao
nms pna bhp ans3 mbi lhm irg lhm wda ykm	mbi lhm irg
kxd ohx ans1 lqx kxd rfm bhp wry	lqx
irg ans1 tpy	tpy
ans1 icy mbi	icy
irg bhp kxd ans1 icy hir rlt	icy
ans3 lhm nvc kxd pgd	lhm nvc kxd
nms hlq fro ans3 nms hlq kxd	nms hlq kxd
ans1 wry dyz hlq bhp wda	wry
hlq nvc hir ans1 god wda hvu lgh	god
ygj ygj ans1 lqx rlt pgd wda pgd	lqx
ans1 ygj ykm rlt rlt wda	ygj
wry ans1 wry god nms god nms	wry
fro ans1 god mbi	god
nms ykm ygj nvc ans3 ykm fro tpy nvc	ykm fro tpy
wry rfm ohx irg ans1 wry icy	wry
nvc lgh god wry ans1 pgd opa tao	pgd
ans1 lgh pna nvc nvc kxd	lgh
nms dyz wry ans1 hlq hir nms ohx ykm	hlq
hvu ans2 kxd wry	kxd wry
lqx wda ans1 dyq ohx	dyq
wda pna ans3 pgd lgh rfm pna lgh ykm nms	pgd lgh rfm
wry hvu ans1 hlq ykm irg pgd	hlq
ans3 tao nms mbi fro	tao nms mbi
hvu tpy hlq kxd ans3 wry rlt opa tpy god hvu	wry rlt opa
rfm hlq ans2 dyq icy pna dyz nvc hcx	dyq icy
tpy ykm ans2 nms lgh tpy ygj	nms lgh
ans2 wry lqx kxd hvu	wry lqx
wda god pgd fro ans2 icy tao	icy tao
rlt bhp wry rfm ans3 dyq icy irg irg nms icy	dyq icy irg
lqx dyq lhm ans1 tao	tao
hlq rlt tao ans1 ygj rlt lhm hir irg	ygj
ans1 bhp tao	bhp
rlt kxd mbi ans2 wry pna	wry pna
hir tpy ans3 hcx lqx dyq kxd	hcx lqx dyq
nvc ans3 rlt lqx lgh ykm mbi dyq tpy	rlt lqx lgh
ans2 hlq opa ygj opa nvc	hlq opa
mbi ans1 mbi irg nvc	mbi
ans3 mbi ygj hcx	mbi ygj hcx
hvu ans1 opa hvu fro mbi dyz	opa
lhm ykm ans3 tpy irg tpy tao tao pgd	tpy irg tpy
god ans3 ykm pgd ygj wry wry fro	ykm pgd ygj
ygj hir fro nms ans3 pgd irg rlt	pgd irg rlt
ygj dyq ans2 bhp rlt ohx lhm nvc god	bhp rlt
kxd ans2 opa opa pgd rlt ykm	opa opa
pgd mbi ans1 pgd hcx mbi	pgd
ans1 tpy nvc mbi god mbi	tpy
ans1 lgh wda wda fro	lgh
hlq dyz ohx lqx ans2 irg opa icy	irg opa
lhm hcx ykm ans3 pgd irg lgh wry ykm	pgd irg lgh
pna irg dyz nms ans1 bhp tpy	bhp
tpy ans3 ygj icy ygj ygj bhp	ygj icy ygj
bhp ykm ans2 hvu nvc	hvu nvc
dyz pgd ans3 rfm tao icy bhp nvc wda	rfm tao icy
lqx pgd nms lqx ans2 god tpy hvu	god tpy
nvc lgh rfm ans1 hvu pgd nms	hvu
opa ans1 pna	pna
ans2 dyz lhm hvu mbi	dyz lhm
pna lhm tao ans2 wda god nms	wda god
nms rlt ans2 fro ohx wda	fro ohx
hcx ykm ans2 irg icy	irg icy
wry opa wda nms ans1 nms kxd dyz icy icy	nms
ans3 ohx lhm tao nms lhm kxd	ohx lhm tao
dyq irg pna ykm ans3 pgd icy tpy rlt tpy pna	pgd icy tpy
hlq ans3 dyq ygj bhp	dyq ygj bhp
ans2 ykm opa	ykm opa
fro dyz pna ans1 lqx lhm wry ohx nms	lqx
rlt ohx hlq ans3 rfm wry hcx	rfm wry hcx
nvc kxd bhp bhp ans1 tao	tao
hcx lhm pna bhp ans3 pna fro hcx pgd ygj	pna fro hcx
ans2 lhm opa opa dyz dyz	lhm opa
fro dyq icy hir ans3 mbi lqx dyq	mbi lqx dyq
ans2 rlt irg rfm pgd	rlt irg
tpy ans1 lhm fro icy	lhm
dyq pna lgh ans3 lqx lhm rfm tpy	lqx lhm rfm
hcx lqx ans3 wda fro ykm hlq	wda fro ykm
bhp ohx mbi ans1 opa lqx	opa
tpy god ans2 tao ykm	tao ykm
ygj ans2 pna bhp ykm dyq	pna bhp
ykm lhm ohx ygj ans1 lqx nms hir hlq wda	lqx
ans3 pgd rlt rfm rlt fro wda pna	pgd rlt rfm
ygj ohx dyq ans3 dyz rlt god hvu lgh lqx	dyz rlt god
icy dyq ans1 dyq tpy hvu dyq	dyq
tpy ans2 pna mbi fro tao lhm	pna mbi
lhm hir rlt lgh ans3 kxd fro rlt opa	kxd fro rlt
icy tao ans1 irg	irg
opa ans2 dyz pna icy hvu	dyz pna
irg ans3 bhp icy nvc ygj pgd rfm	bhp icy nvc
nms hvu ans1 wry hcx lgh wry	wry
ans3 dyz hlq tao tao wda lgh	dyz hlq tao
opa wry hcx lhm ans3 ohx pgd god	ohx pgd god
ohx nvc mbi lhm ans3 god hir mbi dyq ygj ohx	god hir mbi
hvu ans3 kxd ohx nms pna hcx nvc	kxd ohx nms
god tao rfm ans3 wda dyq wda tpy nms opa	wda dyq wda
nms tpy dyq bhp ans2 ykm pgd	ykm pgd
ans3 wry bhp dyq rfm tpy tpy	wry bhp dyq
nvc wda ykm dyz ans2 kxd wda god ykm lgh	kxd wda
hlq nvc kxd pna ans3 fro bhp pna dyq icy	fro bhp pna
fro fro ygj ans1 pgd lhm tpy fro wda	pgd
lhm lhm lgh kxd ans2 dyz nvc	dyz nvc
lgh ykm ans2 wda kxd lgh hcx dyz	wda kxd
rfm ans2 hir dyq nms kxd dyq dyq	hir dyq
ans1 lhm lgh	lhm
lhm ans1 god	god
god nms ans1 ykm tpy opa icy	ykm
irg tpy ans3 bhp hir lhm bhp dyz	bhp hir lhm
dyz hcx ans1 ohx mbi hcx ykm lgh	ohx
tpy tao pna rfm ans1 hlq nms lqx dyz nms	hlq
ans3 ohx pna tao ohx	ohx pna tao
tpy tao rlt ans2 nvc rlt	nvc rlt
nms fro dyz ygj ans3 pgd irg god wda	pgd irg god
hir ans2 dyq pgd ygj tao	dyq pgd
mbi ans1 lqx mbi nms wda	lqx
lgh irg ans2 hir rlt ygj nms	hir rlt
hir ans2 nvc fro fro ykm ykm nms	nvc fro
ykm rfm ans1 tao rfm	tao
fro ans3 icy icy dyq ykm fro lgh hvu	icy icy dyq
lhm ans2 bhp rfm nvc rlt rlt dyq	bhp rfm
dyz ans2 lgh fro kxd ykm	lgh fro
hcx ans2 nms hvu	nms hvu
pna ygj irg hir ans3 hir rlt tpy	hir rlt tpy
fro lgh ans3 dyz hlq hir lqx mbi lgh mbi	dyz hlq hir
ykm ans3 bhp ygj dyz irg	bhp ygj dyz
kxd ans3 wry tpy kxd	wry tpy kxd
tpy icy fro ans1 pna	pna
ygj ans1 lhm nms lgh	lhm
pgd ans2 wry hir bhp wry	wry hir
lhm ans2 nms nms	nms nms
nms nvc lqx ans3 tpy lqx nvc	tpy lqx nvc
ans2 lqx dyq	lqx dyq
ans3 ykm dyq tpy	ykm dyq tpy
ans1 wry icy opa hvu	wry
dyz ans3 tao lqx wry bhp fro	tao lqx wry
wry lqx ans2 nms nms pgd hvu	nms nms
icy wda kxd mbi ans1 ygj	ygj
fro icy hvu ans1 tpy tao	tpy
lhm icy tao ans2 nms hcx dyq	nms hcx
ans1 bhp wry dyz	bhp
lhm mbi ans1 wda dyz dyz	wda
kxd ans2 ohx wry	ohx wry
pgd tao ans1 wry lhm	wry
god pna god kxd ans3 pna dyz god wry bhp	pna dyz god
pna rfm nvc ygj ans1 wda ykm	wda
lqx irg rfm nms ans1 rfm hvu kxd	rfm
lgh hcx ans2 nvc rlt dyz pgd pna hir	nvc rlt
ans3 hlq tao lgh ygj dyz tpy	hlq tao lgh
ygj ans3 rlt hir hvu icy nvc nvc	rlt hir hvu
ans3 pgd irg hir lqx rfm lhm fro	pgd irg hir
ans2 hcx dyz lhm pna	hcx dyz
opa rfm ans3 lqx mbi ohx hcx	lqx mbi ohx
kxd fro nvc ans1 pna	pna
ykm lqx ans3 god fro ygj ygj	god fro ygj
opa tpy ans1 lhm nms pgd	lhm
hlq ans2 lhm rlt lhm opa	lhm rlt
ans2 nms lgh irg ykm hlq	nms lgh
ans3 irg hvu wda tao ykm dyz	irg hvu wda
kxd god ans1 tpy hcx icy opa ohx	tpy
hcx bhp ohx ans3 bhp mbi bhp dyz	bhp mbi bhp
nvc hlq fro ans1 lqx	lqx
bhp hcx wry lqx ans3 fro nvc wda opa	fro nvc wda
ohx nms nvc ans1 tpy lgh	tpy
ans2 rlt rlt dyz bhp	rlt rlt
fro mbi ans3 tpy nvc fro mbi wry rfm nvc	tpy nvc fro
mbi bhp wry pgd ans1 ohx	ohx
ans1 tao lhm opa nms icy	tao
ans1 hlq rlt bhp	hlq
nvc rfm hcx ans3 wry bhp irg tpy nvc tao	wry bhp irg
pgd pgd lgh ans2 lqx ykm wda	lqx ykm
nvc kxd hlq irg ans3 nms ohx hcx wry lgh	nms ohx hcx
ans3 fro wry hvu god	fro wry hvu
rfm pgd kxd ans2 mbi pgd	mbi pgd
tpy opa wda nvc ans3 irg rlt bhp wda opa icy	irg rlt bhp
rlt ans1 dyq	dyq
ans3 hir lqx dyq icy	hir lqx dyq
wry ans1 pgd	pgd
hir ohx ans3 nvc god bhp opa hvu	nvc god bhp
fro rfm ans1 wda mbi	wda
pna tpy ohx ans3 pgd hir god tao rfm tpy	pgd hir god
rfm opa hcx rlt ans3 mbi ohx rlt fro lqx wry hlq	mbi ohx rlt
rlt kxd lgh hcx ans2 mbi dyq ygj	mbi dyq
opa lqx kxd ans1 hlq hlq	hlq
rfm lhm ans1 rlt nms nvc nms	rlt
fro bhp tpy ans2 ykm bhp lhm rlt	ykm bhp
hcx dyz ans1 bhp pgd	bhp
fro tpy nms lhm ans1 god opa	god
hlq fro ans3 mbi dyq ygj	mbi dyq ygj
ans2 rfm lgh irg opa	rfm lgh
icy dyq hcx nms ans1 hir dyz hcx nms wda	hir
tpy lqx opa pna ans2 pgd lgh lgh dyq	pgd lgh
tao icy mbi ans2 nvc ohx	nvc ohx
rlt tao wda ans2 hir pna wry lhm	hir pna
dyq ans1 tpy dyq hvu ykm dyq	tpy
dyq god ans3 bhp kxd fro opa	bhp kxd fro
ans2 pna hcx pgd lqx hvu	pna hcx
lqx hlq ans3 pna lqx pgd nvc ohx hvu	pna lqx pgd
dyz bhp hvu ans3 hir opa nms hir irg nms	hir opa nms
lqx rfm ans2 pna hir ohx	pna hir
ans3 tao pna kxd irg bhp god nms	tao pna kxd
fro ygj pna god ans3 tao hcx hlq nvc pgd kxd tao	tao hcx hlq
hir ans3 hlq dyq irg	hlq dyq irg
icy ohx ans2 ohx kxd hvu	ohx kxd
dyz ans2 nvc opa hvu	nvc opa
nms tpy ans3 rlt fro pna wry hcx	rlt fro pna
icy wda lqx god ans1 nvc wda god kxd	nvc
ygj bhp rfm ans2 hvu irg ohx	hvu irg
ykm ans3 mbi ykm hlq kxd	mbi ykm hlq
ans3 hvu nvc pgd opa god	hvu nvc pgd
bhp ans1 wry lhm nvc irg	wry
ykm tpy ans3 hcx fro opa god mbi pna god	hcx fro opa
god god ans3 god ygj pgd kxd irg mbi	god ygj pgd
ygj wry ans3 ohx bhp mbi hlq	ohx bhp mbi
god pgd lqx hcx ans2 mbi dyz	mbi dyz
ans2 nvc dyq god hvu opa	nvc dyq
bhp god ygj ans2 mbi wry rlt tao ykm	mbi wry
kxd irg tpy ohx ans1 icy	icy
dyq ans1 hcx mbi	hcx
pna ans1 hir lqx icy	hir
ans3 rlt nms tao lqx	rlt nms tao
pna ygj wry irg ans3 hvu mbi hlq lhm	hvu mbi hlq
wry nms ans2 irg fro kxd pgd god	irg fro
ans1 hvu rfm	hvu
irg nvc opa ans3 lqx kxd nms irg	lqx kxd nms
ans1 rfm ykm dyz hir	rfm
dyq ans1 god opa pna	god
lgh ans3 god icy tpy mbi dyz lhm icy	god icy tpy
rlt ykm rlt bhp ans3 ygj wry ygj kxd	ygj wry ygj
dyq opa hcx opa ans2 fro lqx pgd wry opa	fro lqx
kxd ohx ohx ans3 god icy ykm lgh tao	god icy ykm
ohx ans1 bhp hlq	bhp
ykm ans3 ykm hcx irg wda	ykm hcx irg
ans1 rfm hvu ohx	rfm
lgh ans3 ygj wda dyz	ygj wda dyz
irg tpy bhp mbi ans1 tao hvu	tao
hir bhp wda pgd ans1 hlq mbi rlt	hlq
ans2 hcx pna lhm opa lqx	hcx pna
ans3 hir wry hcx ohx	hir wry hcx
hvu irg lgh dyz ans1 nvc ygj lqx icy	nvc
irg nvc ans3 lqx lgh wry	lqx lgh wry
dyq nvc wda ans1 hvu opa icy	hvu
rfm ans3 pgd dyq hvu god hcx hlq	pgd dyq hvu
nms ohx hlq ans1 nms mbi tpy wry	nms
tao wry ans1 tpy nms pgd kxd	tpy
ans2 icy mbi	icy mbi
tao opa ans1 fro hlq tao wda tao	fro
god ans3 dyq wda nvc bhp ygj tpy hvu	dyq wda nvc
ans3 dyq dyq irg tao kxd	dyq dyq irg
ans3 tpy pgd rfm ygj	tpy pgd rfm
ans2 dyq rfm pna	dyq rfm
mbi fro irg ans2 nms lgh	nms lgh
hlq pna wda ans2 pna pna lqx ykm	pna pna
ans3 icy ykm lqx ykm opa hvu nvc	icy ykm lqx
kxd dyz fro ans2 lgh dyq	lgh dyq
tao pgd god dyz ans2 pna god fro opa ygj wry	pna god
ans3 pna hcx lhm lgh	pna hcx lhm
mbi opa hcx kxd ans1 dyq hir hvu opa	dyq
pna lgh rfm ans3 dyz dyz mbi lqx pna lqx hcx	dyz dyz mbi
ans2 irg wda	irg wda
ygj wry ans2 nvc wry fro	nvc wry
nms hvu ans3 kxd hlq nvc lqx tao	kxd hlq nvc
icy ans1 dyq	dyq
lhm lgh ans1 pna tao	pna
lqx dyz rfm ygj ans1 wda nvc lqx tpy	wda
mbi ans2 mbi nms	mbi nms
opa tao nms icy ans2 hcx ohx lhm hir mbi	hcx ohx
icy dyq ykm hvu ans2 mbi opa ygj ykm	mbi opa
pna hir rlt ans1 hcx fro kxd ygj	hcx
mbi irg ohx bhp ans2 hlq pgd pgd nvc wry pna	hlq pgd
god ans3 nvc nvc ygj	nvc nvc ygj
lhm irg god ans1 hcx wry ohx tpy hvu	hcx
lgh tao nvc fro ans1 pgd	pgd
bhp bhp lgh ans1 lhm god lgh	lhm
wda wry ygj ans1 rlt hlq irg lgh	rlt
god wry lhm tpy ans1 ohx pna	ohx
tpy pgd lqx hlq ans3 pgd rfm hir lqx	pgd rfm hir
ygj dyz kxd pgd ans2 ygj god dyz mbi mbi tao	ygj god
ans2 irg wda dyz pgd	irg wda
ygj wry pgd pgd ans1 hlq icy	hlq
bhp ans1 rfm rfm lqx lqx nms	rfm
hvu fro irg nvc ans2 hcx dyz	hcx dyz
ykm wry icy ans3 rlt rfm fro hlq fro	rlt rfm fro
lhm ans2 nms icy hlq rfm mbi rfm	nms icy
bhp lgh ans2 opa pgd wda rfm wry	opa pgd
tao pgd pgd ans3 nms nvc ohx	nms nvc ohx
god ans2 ygj tpy hcx	ygj tpy
lqx ygj hir lhm ans2 dyq lhm pgd	dyq lhm
lgh ans3 wry god ykm	wry god ykm
hlq ykm ans1 lhm nms hvu	lhm
mbi ohx lgh rfm ans2 tpy hlq	tpy hlq
god tao lhm ans3 bhp ygj fro rfm	bhp ygj fro
ans2 hvu god ohx	hvu god
wda god hvu ans3 lhm hvu nms	lhm hvu nms
lgh kxd ans2 tpy dyq	tpy dyq
nms dyz bhp irg ans1 opa pgd wda	opa
irg pna ans1 pna ohx icy	pna
dyq ans1 ykm hlq rlt	ykm
mbi wda lgh god ans1 irg	irg
ygj tao pna hir ans2 tao hvu pgd ykm	tao hvu
pgd rfm hvu kxd ans3 hlq lhm wry lqx bhp ygj	hlq lhm wry
hcx hcx ans3 hlq dyq irg fro lqx	hlq dyq irg
wda ans1 nvc wry lqx pna	nvc
rlt ans2 wda hlq	wda hlq
ans1 wry irg opa wry irg	wry
dyq rlt pgd nvc ans2 nms tpy rfm kxd pna	nms tpy
tao hvu ans2 fro rfm	fro rfm
rlt ans1 ygj irg god	ygj
ans3 ykm fro tpy lhm	ykm fro tpy
bhp dyz ans1 opa	opa
lqx opa dyz ygj ans2 bhp fro bhp wda ygj	bhp fro
tao tpy ans1 fro	fro
lqx pna ans1 lgh kxd fro hvu icy	lgh
lgh ykm god ans1 tao god	tao
pna ans3 irg hvu fro rlt rfm rlt	irg hvu fro
lqx wda nvc ans1 pgd god opa tao	pgd
tpy ans1 opa icy irg	opa
ans3 kxd wda hvu	kxd wda hvu
ans1 hlq hlq ohx wda	hlq
ans2 icy hir ygj lgh	icy hir
bhp ykm dyz ans1 wry pgd ykm fro wda	wry
dyz ans3 dyq icy tao wda	dyq icy tao
irg tao lqx ans2 icy mbi god icy	icy mbi
ans2 dyq fro tao opa lgh	dyq fro
nms hir ygj ans1 rfm tpy bhp nms	rfm
bhp pgd rfm ans3 pgd lqx rlt irg icy	pgd lqx rlt
wda lgh pgd lhm ans1 pgd rlt rfm bhp lhm	pgd
pgd nvc ans3 dyz irg kxd irg	dyz irg kxd
ykm hcx ans1 ohx tpy tao	ohx
ans2 ygj wry	ygj wry
mbi ans1 ykm	ykm
ykm ans3 hlq icy lqx pgd hcx	hlq icy lqx
tao pgd lhm ans2 dyq irg rlt	dyq irg
ans1 hvu hir ykm wda	hvu
irg lhm hir ans3 hlq lqx nvc dyz ygj nms lqx	hlq lqx nvc
ans1 hvu tpy	hvu
kxd ans3 tpy hvu dyz	tpy hvu dyz
ans1 lhm lgh nvc opa rfm	lhm
pgd ans1 opa	opa
ans3 bhp wda wda lgh ygj	bhp wda wda
lgh fro wry ans3 pgd icy mbi dyq nms	pgd icy mbi
kxd lhm ans1 irg	irg
lgh tao ans2 hvu mbi dyq lgh pgd nvc	hvu mbi
ohx ans3 ohx tao opa hlq pgd	ohx tao opa
ans2 irg wry irg wry hvu lqx	irg wry
ans3 hlq dyq lgh pna	hlq dyq lgh
pna ans3 nms lqx icy hlq	nms lqx icy
ykm god ygj ans3 god fro hcx hlq lqx pgd hlq	god fro hcx
rlt lgh ans2 nvc kxd kxd	nvc kxd
mbi mbi ans1 pna icy lqx	pna
ohx hvu lgh pgd ans2 ygj lhm god wda	ygj lhm
hvu tpy god wry ans1 hcx hir tpy tao opa	hcx
lqx ykm dyq ans2 lhm nvc dyq god	lhm nvc
ans2 hcx tpy hcx mbi fro dyz	hcx tpy
nvc ohx nvc ans1 rfm	rfm
tpy fro ans1 kxd pna dyq	kxd
god tao ans2 nvc rfm ohx	nvc rfm
bhp icy ans3 fro bhp irg rlt	fro bhp irg
nms ans3 dyq fro kxd opa pna	dyq fro kxd
mbi wry ans3 ygj pgd god lgh	ygj pgd god
god bhp ykm ans1 ohx hcx pgd	ohx
lgh ykm ans3 wda pna hcx nvc mbi tao	wda pna hcx
ygj kxd wda bhp ans1 lqx nvc fro	lqx
ykm rlt fro ans3 hlq rfm fro lhm nms irg	hlq rfm fro
ans3 wry wda ohx wry	wry wda ohx
mbi pgd ans1 wda god hcx lgh dyz	wda
ans3 fro icy hcx dyz pna god	fro icy hcx
tao tpy ans1 rlt	rlt
ans1 ohx ykm hlq rlt	ohx
irg dyq lhm ans1 hlq kxd irg	hlq
hcx nvc hlq bhp ans3 pna pna pgd hlq hvu pgd	pna pna pgd
wda rlt icy hvu ans2 tpy bhp hcx	tpy bhp
ans3 wry rlt dyz lhm	wry rlt dyz
pna hir ans3 nms ykm ykm irg	nms ykm ykm
mbi fro god ans1 kxd lqx rfm irg pgd	kxd
ohx ans1 lhm dyq	lhm
hir hcx ans1 icy tpy god lgh god	icy
hir mbi ans2 pna fro nms hir lqx hcx	pna fro
lqx ygj nms ans1 hir tao dyz ykm icy	hir
kxd tao ans1 rlt	rlt
ohx ans3 hvu hvu wda mbi mbi pna kxd	hvu hvu wda
hlq ygj ans3 ohx tao god irg hir rfm	ohx tao god
ykm hcx wry rfm ans1 hlq pna wda pna	hlq
pna ans3 fro lqx mbi lqx	fro lqx mbi
tpy nms hvu lhm ans2 icy icy ykm dyz hcx mbi	icy icy
rfm tpy ans2 lhm pgd nvc fro hvu	lhm pgd
wry pgd tpy kxd ans2 opa tao nms	opa tao
wry hvu ygj irg ans1 pna icy hir wry	pna
hvu dyz hcx ans3 fro nms hlq	fro nms hlq
ohx hcx mbi ygj ans1 ykm	ykm
irg fro nms ans3 god icy hlq lqx	god icy hlq
hir dyq pgd ans1 hcx wry rlt	hcx
opa lqx rfm pna ans1 ykm	ykm
dyq lhm ohx bhp ans1 dyz tao	dyz
irg hcx dyq mbi ans3 pgd ykm rlt tpy hlq rfm wda	pgd ykm rlt
nms opa irg ans2 bhp lgh	bhp lgh
ykm hvu ans2 bhp mbi irg bhp bhp	bhp mbi
lqx tao nvc dyz ans1 rlt	rlt
nms irg bhp ans3 wry ohx kxd dyq	wry ohx kxd
irg ans1 mbi hvu pna lgh	mbi
hvu opa bhp ohx ans1 pgd bhp nvc nvc	pgd
icy rfm ans2 tao dyz	tao dyz
ohx ans2 tao bhp nms	tao bhp
rlt dyz rlt icy ans2 lqx god tao rfm mbi ykm	lqx god
hcx fro icy ans2 opa dyq dyq	opa dyq
bhp ans1 nms tao fro	nms
tao wry ans2 nvc irg icy	nvc irg
ans1 icy ygj ygj pgd god	icy
lqx god tpy ans2 fro fro	fro fro
ygj irg hir ans1 mbi fro rlt	mbi
dyq lhm god ans1 rlt	rlt
ans2 lqx lhm hir ohx pna	lqx lhm
rlt hcx fro mbi ans1 fro ohx	fro
mbi nms kxd lhm ans2 pgd ygj icy	pgd ygj
tpy ans1 lhm dyz lhm	lhm
ans1 hir	hir
ans2 pna bhp	pna bhp
tpy nvc lgh hlq ans2 opa dyq god mbi lqx	opa dyq
fro rfm ans3 tao bhp icy ohx tpy	tao bhp icy
ans1 icy irg hir dyq	icy
tao hcx irg rlt ans1 dyq dyq	dyq
opa nms rfm ans2 opa god irg	opa god
ans3 nvc tpy lhm	nvc tpy lhm
dyq lqx lgh ans3 nvc bhp icy tpy	nvc bhp icy
ans3 pna wry ygj hlq	pna wry ygj
hir pgd ans1 dyz	dyz
hir ans1 wda	wda
rlt ygj ans2 lhm hvu hir pna rlt	lhm hvu
ans2 ohx ygj	ohx ygj
mbi pna ans2 icy hcx opa pna rfm	icy hcx
wda ans2 nvc bhp pna	nvc bhp
ohx rlt irg icy ans3 god kxd rlt god	god kxd rlt
hlq ohx opa ohx ans1 nvc hcx	nvc
hlq ans3 ohx hvu lqx lqx	ohx hvu lqx
ans1 dyq	dyq
ygj ans3 kxd lhm dyz	kxd lhm dyz
rfm hir bhp lqx ans1 lqx tpy wda nvc	lqx
nms irg ans2 icy dyq ygj ygj nms	icy dyq
pgd rlt ans1 lhm	lhm
lqx nvc ans3 tao ohx nms pgd hcx nvc	tao ohx nms
hir lqx god ans3 god kxd hvu fro icy bhp hlq	god kxd hvu
opa dyq bhp mbi ans2 opa hlq	opa hlq
lgh lgh ans2 ykm lhm lhm kxd dyz bhp	ykm lhm
dyq wry ykm dyz ans1 lqx hir	lqx
rfm ans1 nvc opa god ohx	nvc
fro wda ans1 ohx rlt lgh	ohx
hlq irg rlt lhm ans3 rlt opa hcx	rlt opa hcx
ans1 ohx	ohx
tpy ans1 lgh nvc dyq	lgh
ans1 lqx tpy	lqx
ans3 mbi nvc ohx god	mbi nvc ohx
lqx lhm ygj icy ans2 opa pgd pna god lhm lhm	opa pgd
kxd hcx tao tpy ans1 irg hvu nvc rlt	irg
ans3 hir kxd ohx god nvc fro hlq	hir kxd ohx
pgd icy wda lhm ans2 mbi bhp ohx lgh opa	mbi bhp
dyq hlq tao ans3 ygj rfm wry kxd rfm	ygj rfm wry
pna ans2 ygj lhm dyz lgh	ygj lhm
hvu ans1 wda lqx	wda
ans1 lqx	lqx
hvu lqx lhm irg ans3 tpy irg hcx hlq nvc	tpy irg hcx
wda hlq pgd wda ans2 hvu rlt nvc	hvu rlt
nms ans2 bhp ykm	bhp ykm
hir dyq pna ans2 hcx bhp irg nvc	hcx bhp
nms ans2 rlt ygj ykm hlq nms	rlt ygj
lgh ans3 wry rlt irg	wry rlt irg
lqx ans3 mbi wry wry	mbi wry wry
hlq fro ans2 lhm opa	lhm opa
god wry lhm rlt ans3 nms god dyz wda	nms god dyz
fro ans2 pgd tpy icy rlt tpy ygj	pgd tpy
rfm wda ans2 tao rfm lqx tao	tao rfm
god rlt ans3 tao rlt tao irg pgd tao	tao rlt tao
ans3 nms rfm ykm hir wda	nms rfm ykm
fro pgd lgh ans1 kxd kxd ohx hlq god	kxd
pgd dyz bhp ans2 tao nms dyz ykm	tao nms
nms wry nms ohx ans2 rlt dyq hvu pna	rlt dyq
dyq ykm ans1 rlt opa rfm lqx rfm	rlt
fro ans3 lhm lqx pna rlt god ykm	lhm lqx pna
icy kxd kxd ans3 tao ohx kxd rfm	tao ohx kxd
hcx dyz dyq dyz ans1 tpy ygj dyz ohx	tpy
ans2 hlq irg bhp ygj	hlq irg
wry nms hcx ans1 wda opa nvc	wda
hcx ans3 fro fro ohx ohx	fro fro ohx
wry irg ans3 nvc lqx pgd nms pna rlt hlq	nvc lqx pgd
ans2 rlt nms bhp opa rfm	rlt nms
ans1 wry tao pgd hvu	wry
icy hir ans3 rlt lqx ykm nvc lgh irg tao	rlt lqx ykm
wda bhp ans3 rfm ygj hcx hir fro	rfm ygj hcx
icy ans1 hvu lhm	hvu
wda lhm dyz god ans3 bhp bhp fro hir hir	bhp bhp fro
rlt irg ans3 ygj dyz opa opa	ygj dyz opa
dyq hir wry ans2 dyq nvc lhm lgh	dyq nvc
ohx ans1 wry dyz	wry
ans2 pna wda bhp	pna wda
ygj lqx ans3 fro fro kxd hvu dyq kxd	fro fro kxd
god nms icy ans3 hlq rfm god tpy icy kxd	hlq rfm god
hlq dyz ans3 rlt ygj wry rfm hir hlq wry	rlt ygj wry
tpy irg mbi ans1 ygj mbi ygj	ygj
tao dyq nms god ans1 dyq irg hcx pna nvc	dyq
nvc tao hvu god ans2 pgd rfm icy god	pgd rfm
nvc bhp icy hir ans1 hir hlq	hir
nvc lhm ans2 icy ykm hlq pna nvc ykm	icy ykm
lqx wda rfm ans1 fro kxd dyq	fro
hvu ans1 pna pna nvc ygj	pna
ans1 wry dyq tpy	wry
lhm ohx ans2 dyq god	dyq god
dyz ans1 irg opa icy	irg
opa god ans1 fro tpy icy nvc	fro
hcx hvu ykm ans1 ykm hlq mbi	ykm
ykm hir fro icy ans2 ohx ohx nms icy lqx	ohx ohx
dyz tpy rfm ans2 wda ygj	wda ygj
ygj wry ans2 ohx rfm nms	ohx rfm
irg hvu dyz ans3 hvu irg tao dyq opa kxd ygj	hvu irg tao
icy ans1 dyq	dyq
tpy ykm ans2 wda rfm icy ygj opa bhp	wda rfm
tpy ans3 ygj opa nms nvc hcx kxd	ygj opa nms
pgd rlt rfm wry ans2 ykm pgd lgh lhm	ykm pgd
lgh ygj nvc ans2 tao nvc	tao nvc
tpy rfm ans1 ohx pna	ohx
hlq icy ygj lgh ans1 dyz ygj hvu dyz fro	dyz
icy hvu ans1 icy	icy
fro hvu ygj lqx ans1 icy wry	icy
ygj ans3 pgd fro ykm nms tpy hlq lhm	pgd fro ykm
pna icy irg opa ans3 tpy dyq ygj rlt lhm ykm	tpy dyq ygj
dyz icy ans2 irg icy tao irg tpy hcx	irg icy
nms lgh ans2 god nvc ohx	god nvc
ans3 kxd bhp tpy hvu rfm fro	kxd bhp tpy
pna ans3 ygj dyq rlt	ygj dyq rlt
dyq mbi ans3 bhp ykm icy	bhp ykm icy
pgd ans3 ygj dyq nvc	ygj dyq nvc
ans3 lgh kxd pna ykm	lgh kxd pna
nvc ans3 dyz pna nvc kxd ykm tpy	dyz pna nvc
pgd ans2 god ohx	god ohx
ans2 hvu tao	hvu tao
hvu pna hvu hcx ans1 fro opa ohx god rlt	fro
dyq rfm ans1 pna irg irg bhp	pna
ans1 kxd pgd irg opa opa	kxd
rfm hlq ans1 lqx hir	lqx
icy hvu wda nvc ans3 hir icy dyz icy	hir icy dyz
kxd rfm tpy ans2 hir ykm	hir ykm
ans2 kxd rfm hcx opa lhm	kxd rfm
dyq ykm ans1 nms kxd irg tpy	nms
dyq ans2 tpy dyz fro	tpy dyz
ans1 dyq rlt dyz rfm	dyq
ans2 icy god dyq dyz opa wda	icy god
nms hvu icy ans1 hvu pna rlt	hvu
ykm ans2 mbi wry dyz tpy	mbi wry
nvc opa lgh ans3 ohx dyz hlq lhm	ohx dyz hlq
kxd ohx lgh hlq ans1 lhm	lhm
ans1 fro hir	fro
irg lgh ans2 tpy icy icy tpy nvc	tpy icy
bhp mbi ans1 nms wda hvu rfm mbi	nms
wry hir dyz ans2 opa lhm ygj	opa lhm
ans3 pgd icy kxd pgd god	pgd icy kxd
fro hcx ygj ygj ans3 tao pna irg	tao pna irg
dyq ans1 dyq ygj nvc dyq tpy	dyq
hlq ans1 hir fro	hir
bhp dyq dyz fro ans2 fro dyq lqx nvc pgd	fro dyq
hir fro ans3 hvu lhm god tao lhm tpy nms	hvu lhm god
opa hvu lhm ans3 lhm rfm wda ohx	lhm rfm wda
ygj tao bhp ans3 nms god pna bhp hcx	nms god pna
ans1 wda	wda
hlq ans2 opa tpy ohx rfm dyz lhm	opa tpy
dyq opa ans2 ygj lhm lgh ohx opa lgh	ygj lhm
ans2 tao rfm nms hlq dyz	tao rfm
hlq pgd lhm ans2 irg rlt nvc irg dyz pna	irg rlt
opa hlq hcx ans1 rfm wda ygj hir	rfm
ans2 wry mbi hir rlt	wry mbi
dyz nms wda dyq ans3 ohx lhm hlq pgd mbi dyq	ohx lhm hlq
nms ans1 god mbi god hlq	god
ans2 irg nvc hlq	irg nvc
god wry hvu tpy ans2 rlt irg nvc bhp lqx icy	rlt irg
hcx kxd ygj dyq ans2 lhm ohx tao tao pna pgd	lhm ohx
pgd rlt ans2 opa pgd	opa pgd
hvu wda ans3 hir bhp nvc wda hir hlq kxd	hir bhp nvc
ykm mbi opa ans3 hvu bhp mbi	hvu bhp mbi
icy ans3 hvu ohx lgh	hvu ohx lgh
ans1 nms dyz hvu tpy hlq	nms
fro ohx mbi ans2 rfm dyz hir fro	rfm dyz
dyz wry ans3 hvu fro tao irg hvu pna ykm	hvu fro tao
god tao hvu ans3 mbi fro nvc dyq icy hlq ygj	mbi fro nvc
ans3 icy wda lhm rfm nms irg kxd	icy wda lhm
fro tpy ohx nvc ans1 rlt bhp	rlt
ykm dyz dyq kxd ans3 kxd rfm wry hcx mbi opa hvu	kxd rfm wry
tao icy ans3 lhm rlt rfm opa	lhm rlt rfm
rlt ans1 ygj kxd ykm	ygj
dyq rlt kxd lqx ans1 hlq nvc hcx tpy	hlq
ans1 rfm tao rlt ygj	rfm
nvc ans1 tao hcx	tao
nms ans2 tpy fro	tpy fro
ygj lqx irg lqx ans2 fro ykm dyq bhp	fro ykm
kxd lqx ans1 lhm	lhm
rlt hcx ans2 bhp irg fro	bhp irg
god rlt ans3 hcx ygj lhm hlq	hcx ygj lhm
nms irg pgd hvu ans2 wry dyq kxd kxd ykm	wry dyq
ans2 rlt tao bhp mbi hlq rfm	rlt tao
tao opa fro tao ans3 rfm kxd hcx ohx tpy	rfm kxd hcx
hcx ans2 lgh god	lgh god
tpy ans3 kxd wry rlt	kxd wry rlt
icy lqx rfm ans2 rlt fro wda hcx	rlt fro
ans1 dyq lhm wry	dyq
mbi ans3 tpy hlq pgd irg lhm wry wda	tpy hlq pgd
ans3 fro hvu dyz	fro hvu dyz
hvu dyz lgh lqx ans2 bhp ohx	bhp ohx
hcx nms dyq ans3 irg fro lhm ohx hlq hcx god	irg fro lhm
opa irg irg ygj ans2 hir tao mbi	hir tao
tpy hcx wda wda ans3 hlq tao tao lqx hir tao dyq	hlq tao tao
pna nms fro ans1 lhm	lhm
ans1 lqx tpy	lqx
wry dyq ykm nvc ans1 hvu pgd	hvu
dyq ans3 tpy dyq ykm	tpy dyq ykm
god pna ans2 mbi icy	mbi icy
lhm wda pgd opa ans1 hlq nms	hlq
opa rlt opa ans3 ohx ygj irg ohx bhp wda	ohx ygj irg
icy ygj god tao ans1 nvc pgd	nvc
hir dyq icy dyq ans1 opa nvc nms ygj	opa
lgh rfm ans3 lhm wda nvc opa wry	lhm wda nvc
ans1 pna hlq	pna
hvu ans1 lqx nvc dyz	lqx
fro nms ans1 lhm opa nms	lhm
hvu ohx lhm ans1 rfm lhm	rfm
ans2 bhp tpy rlt	bhp tpy
nms ans1 mbi lqx dyq ohx tao	mbi
pna nms ans1 fro mbi	fro
fro mbi icy tao ans3 irg pgd mbi dyq tpy	irg pgd mbi
irg god hcx ans1 mbi nms tpy	mbi
rlt opa irg mbi ans2 wry hlq bhp dyz rfm hvu	wry hlq
ans2 lhm tpy pna lhm opa rlt	lhm tpy
ygj ans3 rlt nms nvc ygj	rlt nms nvc
hcx lhm tpy wda ans1 fro opa	fro
fro irg ans2 tpy hvu fro kxd	tpy hvu
ans2 dyz wry rfm nvc	dyz wry
ans1 ykm dyq icy rfm nvc	ykm
pgd fro opa ans1 ohx opa ohx lgh lgh	ohx
pna rlt ans2 irg hvu rlt	irg hvu
ygj nvc mbi ans2 mbi wda dyz lhm tpy pna	mbi wda
tao pna ans3 opa nms wry ygj dyz	opa nms wry
nms ans1 tao fro tao pgd	tao
nvc ans1 ohx	ohx
hcx hlq rlt rlt ans3 lqx kxd rlt ykm ohx pna ygj	lqx kxd rlt
tao opa ans3 pgd hvu rfm hvu	pgd hvu rfm
bhp lgh dyz ans1 ygj lgh hlq mbi	ygj
ykm tao nvc ans2 nms god ohx irg hlq	nms god
ans1 hlq nvc	hlq
lhm lgh dyz nms ans2 hcx nvc hlq kxd wda	hcx nvc
pna lhm icy ans2 nvc hcx lqx opa	nvc hcx
pna opa ans2 nms hir god	nms hir
hcx ans2 dyz hir wda dyz kxd	dyz hir
opa opa tao lgh ans2 god ykm pgd lqx	god ykm
rfm hcx hvu ans3 wda hvu ygj	wda hvu ygj
kxd ans3 kxd lgh hir lhm lhm lgh	kxd lgh hir
ygj ohx hcx ans3 kxd pna lgh pgd lgh ygj fro	kxd pna lgh
ans1 fro lhm nms opa kxd	fro
lgh nvc tpy wda ans2 dyq hlq hir mbi rfm tao	dyq hlq
fro hlq rlt ans3 fro dyz lgh opa wda	fro dyz lgh
lqx kxd tpy ans1 hlq tpy rfm	hlq
tpy wda ans2 pgd nvc wda	pgd nvc
wry ans1 dyq hcx	dyq
tao ans2 hir lqx rlt	hir lqx
wda wda wda ans2 fro ygj dyz kxd nms bhp	fro ygj
kxd hcx icy lqx ans2 dyq pna fro hcx	dyq pna
opa ygj rfm ans3 lhm god ykm hir pgd	lhm god ykm
pna pna nms ans2 nms god hcx pna rlt lgh	nms god
hir ans3 bhp dyq opa rlt	bhp dyq opa
ohx ans2 tao opa hvu opa ygj	tao opa
ohx fro ans2 kxd opa	kxd opa
icy ans3 nvc rlt wda dyz nms wda nms	nvc rlt wda
ykm ohx ans1 hir irg mbi wda	hir
lqx hvu wda lgh ans3 mbi pgd pna hlq fro ykm	mbi pgd pna
icy god ohx rlt ans1 god god hlq bhp dyz	god
wda opa tpy dyq ans2 tao opa dyq	tao opa
lhm rfm ans1 wry tao	wry
lqx hir god tpy ans2 rlt pna	rlt pna
hir lgh ans3 ygj lqx wry	ygj lqx wry
hvu ygj bhp ans2 rlt ohx hvu wry	rlt ohx
kxd ans1 rlt hvu ykm	rlt
ykm hcx dyz icy ans3 hir hir hcx ohx hcx	hir hir hcx
ans2 rlt nvc	rlt nvc
hcx god pna ans2 nms lgh tao icy ygj	nms lgh
hcx dyq fro rfm ans1 irg kxd mbi wry	irg
ans3 dyq irg nvc lgh	dyq irg nvc
bhp mbi ans1 bhp tao irg	bhp
